Xoc, Xoc, Xoc, Xoc, Xoc, Xoc, Xoc, Xoc, Xoc, Xoc, Xoc, Xoc, Xoc, Xoc, Xoc, Xoc, Xoc, Xoc, Xoc, Xoc, Xoc, Xoc, Xue, Xoc, Xoc, Xoc, Xoc, Xoc, Xu, Xoc, Xoc, Xoc, Xue, Xoc, Xoc, Xoc, Xoc
Xoc, Xoc, Xoc, Xoc, Xoc, Xoc, Xoc, Xoc, Xoc, Xoc, Xoc, Xoc, Xoc, Xoc, Xoc, Xoc, Xoc, Xoc, Xoc, Xoc, Xoc, Xoc, Xue, Xue, Xoi, Xu, Xu, Xu, Gg, Xu, Xu, Xue, Xue, Xoc, Xoc, Xoc, Xoc
Xoc, Xoc, Xoc, Xoc, Xoc, Xoc, Xoc, Xoc, Xoc, Xoc, Xoc, Xoc, Xoc, Xoc, Xoc, Xoc, Xoc, Xoc, Xoc, Xoc, Xoc, Xoc, Xoc, Xoi, Xu, Xu, Qxua, Gg, Qxua, Qxua, Qxua, Xu, Xu, Xue, Xue, Xoc, Xoc
Xoc, Xoc, Xoc, Xoc, Xoc, Xoc, Xoc, Xoc, Xoc, Xoc, Xoc, Xoc, Xoc, Xoc, Xoc, Xoc, Xoc, Xoc, Xoc, Xoc, Xoc, Xoc, Xoc, Xoi, Xu, Xu, Qxua, Qxua, Xu, Qxua, Qxua, Qxua, Gg, Xu, Xue, Xoc, Xoc
Xoc, Xoc, Xoc, Xoc, Xoc, Xoc, Xoc, Xoc, Xoc, Xoc, Xoc, Xoc, Xoc, Xoc, Xoc, Xoc, Xoc, Xoc, Xoc, Xoc, Xoc, Xoc, Xue, Xoi, Xu, Xu, Qxua, Xu, Qxua, Qxua, Gg, Qxua, Qxua, Gg, Xue, Xoc, Xu
Xu, Xoc, Xoc, Xoc, Xoc, Xoc, Xoc, Xoc, Xoc, Xoc, Xu, Xoc, Xoc, Xoc, Xoc, Xoc, Xu, Xoc, Xu, Xoc, Xu, Xu, Xu, Xu, Iwc^Ii, Iwc, Xu, Xu, Qxua, Qxua, Qxua, Qxua, Qxua, Qxua, Xue, Xu, Xu
Xu, Xu, Xu, Xoc, Xu, Xoc, Xu, Xoc, Xoc, Xoc, Xoc, Xoc^Efs, Iwc^Ii, Iwc^Ii, Iwc^Ii, Xoc^Efs, Xoc, Xoc, Xoc, Xoc, Xoc, Xoc, Xoc, Xu, Xu, Xu, Xu, Xu, Gg, Qxua, Qxua, Qxua, Gg, Qxua, Xu, Xu, Xu
Xu, Xu, Xu, Xu, Xu, Xoc, Xoc, Xoc^Efs, Iwr, Iwr, Gg^Ve, Iwr^Ii, Iwc, Iwc, Iwc, Iwr^Ii, Gg^Ve, Iwr, Iwr, Xoc^Efs, Xoc, Xoc, Xoc, Xoc, Xu, Xu, Xu, Xu, Gg, Qxua, Qxua, Gg, Qxua, Qxua, Xu, Xu, Xu
Xu, Xu, Xu, Xu, Xoc, Xoc, Iwr, Iwr, Qxu, Iwr, Iwr, Iwc, Cud, Cud, Cud, Iwc, Iwr, Iwr, Qxu, Iwr, Iwr, Xoc, Xoc, Xoc, Xoc, Xu, Xu, Xu, Qxua, Qxua, Qxua, Qxua, Qxua, Qxua, Xu, Xu, Xu
Xu, Xu, Xu, Xu, Xoc, Xoc, Uu, Uu, Qxu, Qxu, Uu, Iwc, Cud, Kud^Ii, Cud, Iwc, Uu, Qxu, Qxu, Uu, Uu, Xoc, Xu, Xu, Xu, Xu, Xu, Xu, Xu, Qxua, Qxua, Qxua, Gg, Xu, Xu, Xu, Xu
Xu, Xu, Xu, Xu, Xoc, Xoc, Uu, Uu, Uu, Qxu, Uu^Vud, Iwc, Iwc, Cud, Iwc, Iwc, Uu^Vud, Qxu, Uu, Uu, Uu, Xoc, Xu, Xu, Xu, Xu, Xu, Xu, Qxua, Qxua, Qxua, Gg, Xu, Xu, Xu, Xu, Xu
Xu, Xu, Xoc, Xoc, Xoc, Xoc, Uu^Ebn, Uu, Uu, Urb, Urb, Iwr, Iwc, Iwc, Iwc, Iwr, Urb, Urb, Uu, Uu^Es, Uu^Ebn, Xoc, Xu, Xu, Xu, Xu, Xu, Xu, Qxua, Qxua, Qxua, Qxua, Xu, Xu, Xu, Xu, Xu
Xu, Xu, Xu, Xoc, Xoc, Xoc, Xoc, Xoc^Efs, Uu, Urb, Urb, Xoc^Efs, Xoc, Xoc, Xoc, Xoc^Efs, Urb, Urb, Uu, Xoc^Efs, Xoc, Xoc, Xu, Xu, Xu, Xu, Xu, Xu, Gg, Qxua, Qxua, Xu, Xu, Xu, Xu, Xu, Xu
Xu, Xu, Xu, Xu, Xu, Xu, Xoc, Uu, Uu, Uu^Es, Uu^Ebn, Urb, Uu^Ii, Uu^Emf, Uu^Ii, Urb, Uu^Ebn, Uu, Uu, Uu, Xoc, Xoc, Xoc, Xu, Xu, Xu, Xu, Xu, Qxua, Gg, Qxua, Qxua, Xu, Xu, Xu, Xu, Xu
Xu, Xu, Xu, Xu, Xu, Xu, Xoc, Uu, Uu, Qxu, Qxu, Urb, Uu^Ii, Uu^Emf, Uu^Ii, Urb, Qxu, Qxu, Uu, Uu, Xoc, Xoc, Xoc, Xu, Xu, Xu, Xu, Qxua, Qxua, Qxua, Qxua, Qxua, Xu, Xu, Xu, Xu, Xu
Xu, Xu, Xu, Xu, Xu, Xu, Xoc, Uu, Uu, Qxu, Uu^Vud, Urb, Xoc, Uu^Emf, Xoc, Urb, Uu^Vud, Qxu, Uu, Uu, Xoc, Xu, Xoc, Xu, Xu, Xu, Xu, Qxua, Qxua, Qxua, Gg, Gg, Xu, Xu, Xu, Xu, Xu
Xu, Xu, Xu, Xu, Xu, Xu, Xoc, Xoc, Gs^Fds, Uu, Urb, Urb, Xoc, Uu^Emf, Xoc, Urb, Urb, Uu, Gs^Fds, Xoc, Xoc, Xu, Xoc, Xu, Xu, Xu, Xu, Xu, Qxua, Qxua, Qxua, Qxua, Xu, Xu, Xu, Xu, Xu
Xu, Xu, Xu, Xu, Xu, Xu, Xu, Xoc, Xoc, Uu, Urb, Xoc, Xoc, Xoc, Xoc, Xoc, Urb, Uu, Xoc, Xoc, Xu, Xu, Xu, Xu, Xu, Xu, Xu, Xu, Qxua, Qxua, Qxua, Qxua, Xu, Xu, Xu, Xu, Xu
Xu, Xu, Xu, Xu, Xu, Xu, Xu, Xoc, Xoc, Urb, Uu, Xoc, Xoc^Efs, Xoc, Xoc^Efs, Xoc, Uu^Es, Urb, Xoc, Xoc, Xu, Xos, Xu, Xu, Xu, Xu, Xu, Xu, Qxua, Qxua, Qxua, Xu, Xu, Xu, Xu, Xu, Xu
Xu, Xu, Xu, Xu, Xoc, Xoc, Xoc^Efs, Xoc, Urb, Urb, Uu, Uu, Gs^Fds, Uu^Ebn, Gs^Fds, Uu, Uu, Urb, Urb, Xoc, Xoc^Efs, Xoc, Xoc, Xos, Xu, Xu, Xu, Xu, Gg, Xuf, Gg, Xu, Xu, Xu, Xu, Xu, Xu
Wo, Wo, Wo, Xoc, Xoc, Gs^Fds, Uu^Es, Uu, Urb, Uu, Ww, Ww, Ww, Gs^Fds, Ww, Ww, Ww, Uu, Urb, Uu, Uu, Gs^Fds, Xoc, Xoc, Wo, Wo, Wo, Hh, Gg, Gg, Gg, Hh, Xu, Xu, Xu, Xu, Xu
Wo, Wo, Wo, Wo, Wo, Ww, Ww, Ww, Ww^Bsb|, Ww, Ww^Ewf, Wo, Wo^Ii, Ww^Ii, Wo^Ii, Wo, Ww^Ewf, Ww, Ww^Bsb|, Ww, Ww, Ww, Wo, Wo, Wo, Wo, Wo, Hh, Gg, Gg^Fet, Gg, Hh, Xu, Xu, Xu, Xu, Xu
Xu, Xu, Xoc, Wo, Uu, Ww, Uu, Uu, Urb, Ww, Ww, Wo, Ww^Ii, Gg^Fet, Ww^Ii, Wo, Ww, Ww, Urb, Uu, Uu, Ww, Uu, Wo, Xoc, Xu, Xu, Hh, Hh, Gg, Hh, Hh, Xu, Xu, Xu, Xu, Xu
Xu, Xu, Xoc, Xoc, Gs^Fds, Uu, Gg^Ve, Urb, Urb, Gs^Fds, Gs^Fds, Ww, Gs^Fds, Ww^Ii, Gs^Fds, Ww, Gs^Fds, Gs^Fds, Urb, Urb, Gg^Ve, Uu, Gs^Fds, Xoc, Xoc, Xu, Xu, Xu, Xu, Xu, Xu, Xu, Xu, Xu, Xu, Xu, Xu
Xu, Xu, Xu, Xoc, Xoc, Gs^Fds, Gs^Fds, Urb, Urb, Uu, Xoc, Gs^Fds, Xoc, Gs^Fds, Xoc, Gs^Fds, Xoc, Uu, Urb, Urb, Gs^Fds, Gs^Fds, Xoc, Xoc, Xu, Xu, Xu, Xu, Xu, Xu, Xu, Xu, Xu, Xu, Xu, Xu, Xu
Xu, Xu, Xu, Xu, Xoc, Xoc, Xoc, Xoc, Gs^Fds, Urb, Ur^Ii, Xoc^Efs, Xoc, Xoc, Xoc, Xoc^Efs, Ur^Ii, Urb, Gs^Fds, Xoc, Xoc, Xoc, Xoc, Xu, Xu, Xu, Xu, Xu, Xu, Xu, Xu, Xu, Xu, Xu, Xu, Xu, Xu
Xu, Xu, Xu, Xu, Xu, Xoc, Xoc, Gs^Fds, Xoc^Efs, Urb, Ur, Ur, Ur, Gg^Ve, Ur, Ur, Ur, Urb, Xoc^Efs, Gs^Fds, Xoc, Xu, Xu, Xu, Xu, Xu, Xu, Xu, Xu, Xu, Xu, Xu, Xu, Xu, Xu, Xu, Xu
Xu, Xu, Xu, Xu, Xu, Xoc, Xoc, Gs^Fds, Gs^Fds, Urb, Urb, Ur, Cud, Ur^Ebn, Cud, Ur, Urb, Urb, Gs^Fds, Gs^Fds, Xoc, Xu, Xu, Xu, Xu, Xu, Xu, Xu, Xu, Xu, Xu, Xu, Xu, Xu, Xu, Xu, Xu
Xu, Xu, Xu, Xu, Xu, Xoc, Xoc, Xoc, Xoc, Gg^Ve, Uu, Urb, Cud, Kud^Ii, Cud, Urb, Uu, Gg^Ve, Xoc, Xoc, Xoc, Xoc, Xu, Xu, Xu, Xu, Xoc, Xoc, Xoc, Xoc, Xoc, Xu, Xoc, Xu, Xu, Xu, Xu
Xu, Xu, Xu, Xu, Xu, Xu, Xu, Xu, Xoc, Xoc, Uu^Ebn, Urb, Urb, Cud, Urb, Urb, Uu^Ebn, Xoc, Xoc, Xu, Xu, Xu, Xoc, Xoc, Xoc, Xoc, Xoc, Xoc, Xoc, Xoc, Xoc, Xoc, Xoc, Xoc, Xoc, Xoc, Xoc
Xu, Xoc, Xu, Xoc, Xu, Xoc, Xu, Xoc, Xu, Xoc, Xoc, Uu, Urb, Urb, Urb, Uu, Xoc, Xoc, Xu, Xu, Xu, Xoc, Xoc, Xoc, Xoc, Xoc, Xoc, Xoc, Xoc, Xoc, Xoc, Xoc, Xoc, Xoc, Xoc, Xoc, Xoc
Xoc, Xoc, Xoc, Xoc, Xoc, Xoc, Xoc, Xoc, Xoc, Xoc, Xoc, Xoc, Urb, Urb, Urb, Xoc, Xoc, Xoc, Xoc, Xoc, Xoc, Xoc, Xoc, Xoc, Xoc, Xoc, Xoc, Xoc, Xoc, Xoc, Xoc, Xoc, Xoc, Xoc, Xoc, Xoc, Xoc
