Mm, Mm, Mm, Mm^Xm, Mm, Mm, Mm, Mm, Mm, Mm, Mm, Mm, Mm, Mm, Mm, Mm, Mm, Mm, Mm, Mm, Mm, Mm, Mm, Mm, Mm, Mm, Mm, Mm, Mm, Mm, Mm, Mm, Mm^Xm, Mm, Mm^Xm, Mm, Mm, Mm, Mm, Mm, Mm, Mm, Mm, Mm, Hh, Hh, Ss, Ss, Gs^Fp, Gs^Fp
Mm, Mm, Mm, Mm^Xm, Mm^Xm, Mm^Xm, Mm^Xm, Mm, Mm, Mm, Mm, Mm, Mm, Mm, Mm, Mm, Mm, Mm, Mm, Mm, Mm, Mm, Mm, Mm, Mm, Mm, Mm, Mm, Mm, Mm, Mm, Mm^Xm, Mm^Xm, Mm^Xm, Mm^Xm, Mm, Mm, Mm, Mm, Mm, Hh, Mm, Hh, Hh, Hh, Hh, Ss, Gs^Fp, Gs^Fp, Gs^Fp
Mm, Mm, Mm, Mm^Xm, Mm^Xm, Mm^Xm, Mm^Xm, Mm^Xm, Mm^Xm, Mm^Xm, Mm^Xm, Mm^Xm, Mm, Mm, Mm, Mm, Mm, Mm, Mm, Mm, Hh, Hh, Hh, Mm, Hh, Hh, Hh, Mm, Hh, Mm, Mm, Mm, Mm, Mm^Xm, Mm^Xm, Mm, Hh, Mm, Hh, Hh, Hh, Hh, Hh, Hh, Ww, Ss, Gs^Fp, Gs^Fp, Re, Ss
Mm, Mm, Mm^Xm, Mm^Xm, Mm^Xm, Mm, Mm^Xm, Mm^Xm, Mm^Xm, Mm^Xm, Mm, Mm, Mm, Mm, Mm, Mm, Chr, Chr, Hh, Hh, Hh, Hh, Hh, Hh, Hh, Hh, Hh, Hh, Hh, Hh, Hh, Mm, Hh, Mm, Mm, Hh, Hh, Hh, Hh, Hh, Gs^Fp, Hh, Ww, Ww, Chr, Gs^Fp, Re, Re, Ss, Ss
Mm, Mm, Mm^Xm, Mm^Xm, Mm^Xm, Mm^Xm, Mm, Mm^Xm, Mm^Xm, Mm^Xm, Mm^Xm, Mm, Mm, Mm, Mm, Mm, Chr, Chr, Chr, Hh, Hh, Hh, Hh, Hh, Hh, Hh, Gs^Fp, Gs^Fp, Gs^Vh, Hh, Hh, Hh, Hh, Hh, Hh, Hh, Ww^Bw|, Gs^Fp, Gs^Fp, Gs^Fp, Gs^Fp, Gs^Fp, Ww^Bw/, Ww^Bw/, Ss, Re, Gs^Fp, Gs^Fp, Gs^Fp, Gs^Fp
Mm, Mm^Xm, Mm^Xm, Mm, Mm, Mm, Mm, Mm, Mm, Mm^Xm, Mm^Xm, Mm, Mm, Mm, Mm, Mm, Hh, Ke, Hh, Hh, Hh, Hh, Hh, Ww, Ww, Gs^Fp, Gs^Fp, Gs^Fp, Gs^Fp, Gs^Fp, Sm, Hh, Sm, Sm, Ss, Ss, Re, Gs^Fp, Gs^Fp, Gs^Fp, Re, Re, Ww, Ww, Gs^Fp, Gs^Fp, Gs^Fp, Ss, Ss, Ss
Mm^Xm, Mm^Xm, Mm, Mm^Xm, Mm, Mm, Mm, Mm, Mm, Mm, Mm, Mm, Hh, Mm, Hh, Hh, Hh, Hh, Hh, Hh, Hh, Hh, Gg, Ss, Gs^Fp, Gs^Vh, Gs^Fp, Gs^Fp, Gs^Fp, Gs^Fp, Sm, Sm, Sm, Sm, Ss, Gs^Fp, Re, Gs^Fp, Re, Re^Es, Gs^Fp, Gs^Fp, Ww, Ww, Ss^Vhs, Ss, Ss^Vhs, Ss, Ss, Ss
Mm, Mm^Xm, Mm^Xm, Mm^Xm, Mm, Mm, Mm, Mm, Mm, Mm, Hh, Hh, Hh, Hh, Hh, Hh, Hh, Hh, Gg, Hh, Gg, Gg, Ss, Ss, Gs^Fp, Gs^Fp, Gs^Fp, Gs^Fp, Gs^Fp, Gs^Fp, Gs^Fp, Sm, Gs^Fp, Gs^Fp, Gs^Fp, Gs^Vl, Gs^Fp, Re, Gs^Fp, Gs^Fp, Ss, Ss, Ww, Ww, Ww, Gs^Fp, Gs^Fp, Ss, Ss, Ss
Mm^Xm, Mm, Mm^Xm, Mm, Mm, Mm, Mm, Mm, Mm, Hh, Hh, Hh, Hh, Hh, Hh, Hh, Re, Gg, Gs^Efm, Gg^Es, Gs^Efm, Ss, Ss, Ss, Ss, Gs^Fp, Gs^Fp, Gs^Fp, Gs^Fp, Gs^Fp, Ss, Ss, Ss, Ss, Gs^Fp, Gs^Fp, Re, Re, Gs^Fp, Ss, Ss, Ss, Ss, Ww, Ww, Ww, Gs^Fp, Ss, Ss, Ss
Mm^Xm, Mm^Xm, Mm^Xm, Mm^Xm, Mm, Mm, Mm, Mm, Hh, Hh, Hh, Hh, Hh, Hh, Hh, Hh, Ww^Bw|, Ss, Gg, Gs, Gg^Efm, Gg^Efm, Ss, Ss, Ss, Ss, Ss, Ss, Ss, Ss, Ss, Ss, Gs^Fp, Ss, Gs^Fp, Ss, Chr, Ss, Ss, Ss, Ss, Ss, Gs^Fp, Gs^Fp, Ww, Ww, Ww, Gs^Fp, Ss, Ss
Mm^Xm, Mm, Mm^Xm, Mm^Xm, Mm, Mm, Mm, Hh, Hh, Hh, Hh, Hh, Ss, Hh, Ss, Ss, Chs, Ss, Ww, Ww, Ww, Ww, Ss, Ss, Ss, Ss, Ss, Ss, Ss, Ss, Ss, Hh, Hh, Hh, Hh, Ss, Ss, Re, Gg^Es, Ss, Ss, Ss, Ss, Ss, Ww, Ww, Ww, Ww, Ss, Ss
Mm^Xm, Mm^Xm, Mm^Xm, Mm, Mm, Mm, Mm, Hh, Hh, Hh, Gg^Es, Gg, Ss, Ss, Ss, Chs, Ss, Ww, Ww, Ww, Ww, Ww, Ss, Ss, Ss, Ss, Ss, Hh, Ss, Hh, Hh, Hh, Hh, Hh, Hh, Hh, Gg^Dr, Re, Sm, Ss, Sm, Ss, Ss, Ss, Ww, Ww, Ww, Ww, Ww, Ww
Mm^Xm, Mm^Xm, Mm, Mm, Mm, Mm, Hh, Hh, Hh, Hh, Hh, Gg, Ss, Ss, Ss, Re, Ss^Vhs, Ww, Ww, Ww, Ww, Ww, Ww, Gg, Gg, Ss, Hh, Hh, Mm^Xm, Mm^Xm, Mm^Xm, Mm, Hh, Mm, Re, Hh, Re, Re, Sm, Sm, Sm, Ss, Ss, Gs^Fp, Ww, Ww, Ww, Ww, Ww, Ww
Mm^Xm, Mm^Xm, Mm, Mm, Mm, Mm, Mm, Hh, Hh, Hh, Hh, Ss, Ss, Ss, Re, Re, Ss, Ww, Ww, Ww, Ww, Ww, Gg^Ve, Gg, Ss, Hh, Mm^Xm, Mm^Xm, Mm^Xm, Mm^Xm, Hh, Hh, Re, Re, Hh, Re, Gs^Vl, Gg^Efm, Sm, Sm, Ss, Ss, Gs^Fp, Gs^Fp, Ss, Ww, Ww, Ss, Ss, Ss
Mm^Xm, Mm^Xm, Mm^Xm, Mm, Mm, Mm, Mm, Hh, Hh, Hh, Hh, Hh, Ss, Re, Gg, Gg, Gs^Vh, Ww, Wo, Wo, Ww, Ss, Gg, Gg, Gg, Hh, Mm^Xm, Mm^Xm, Mm^Xm, Hh, Hh, Re, Ss, Ss^Vhs, Gg^Edt, Gg^Edt, Ker^Edt, Gg^Edt, Hh, Ss, Hh, Ss, Ss, Ss, Ss, Ww, Ww, Ss, Ss, Ss
Mm^Xm, Mm^Xm, Mm^Xm, Mm^Xm, Mm, Mm, Mm, Hh, Hh, Hh, Hh, Gg, Gg^Efm, Re, Re^Efm, Gg, Gg, Ww, Wo, Wo, Ww, Ss, Gg, Gg, Hh, Mm, Mm^Xm, Mm^Xm, Hh, Hh, Chs, Chs, Ss, Ss, Cer^Edt, Cer^Edt, Cer^Edt, Ss, Hh, Mm, Mm^Xm, Mm^Xm, Hh, Ss, Ss, Gs^Vl, Sm, Ss, Ss, Ss
Mm^Xm, Mm, Mm, Mm, Mm, Mm, Hh, Hh, Hh, Hh, Gs, Gs^Efm, Gs^Efm, Gs^Efm, Gg, Re, Ww, Ww, Ww, Ww, Ss, Ss, Gll^Fp, Gg, Hh, Mm, Mm, Hh, Hh, Ss, Ww^Bw|, Ss, Ss, Ss, Ss, Cer^Edt, Ss, Ss, Mm, Mm^Xm, Mm^Xm, Mm^Xm, Mm, Hh, Re, Re, Sm, Sm, Sm, Sm
Mm^Xm, Mm, Mm, Mm, Mm, Hh, Hh, Hh, Hh, Hh, Hh, Gs, Gg, Gg^Efm, Gs^Vh, Re, Gg, Gs, Gg, Gg, Ss, Gll^Fp, Gll^Fp, Gg, Hh, Hh, Hh, Hh, Ss, Ss, Chr, Ss, Ss, Ss, Ss, Ss, Ss, Hh, Mm, Mm^Xm, Mm^Xm, Mm, Mm, Mm, Re, Sm, Ss, Sm, Ss, Sm
Mm^Xm, Mm, Mm, Mm, Hh, Hh, Hh, Hh, Gg, Hh, Gll^Fp, Hh, Hh, Gg, Gg, Re, Gs, Gs^Dr, Gg^Es, Ss, Gg, Gll^Fp, Gll^Fp, Gll^Fp, Re, Re, Re^Edt, Gg, Re^Edt, Re^Edt, Gg^Edt, Gg^Edt, Ss, Ss, Ss, Ss, Ss, Ss, Mm, Mm, Mm^Xm, Mm^Xm, Mm, Mm, Gg, Re, Re, Ss, Ss, Gg
Mm, Mm, Mm, Mm, Mm, Hh, Hh, Gg, Gg, Gll^Fp, Gll^Fp, Gll^Fp, Gll^Fp, Ss, Gg, Re, Gg, Gg, Gg, Gg, Gg, Gg, Re, Re, Gg, Gg, Gg^Edt, Re^Edt, Gg^Edt, Gg^Edt, Gs^Vh, Gg^Efm, Gs^Efm, Ss, Ss, Ss, Ss, Hh, Mm, Mm^Xm, Mm^Xm, Mm^Xm, Mm, Mm, Gs^Vl, Re, Re, Gg, Ss, Gg
Mm, Mm, Mm, Mm, Mm, Hh, Hh, Hh, Gs, Gs, Gg, Gll^Fp, Gll^Fp, Gll^Fp, Gs^Efm, Re, Gg, Hh, Hh, Hh, Hh, Hh, Re, Ss, Ss, Ss, Gg, Gg^Edt, Gg, Gg^Edt, Ww, Gs^Efm, Gs, Ss, Ss, Ss, Ss^Vhs, Hh, Mm^Xm, Mm^Xm, Mm^Xm, Mm^Xm, Mm, Hh, Gg, Re, Re, Gs^Vl, Ss, Ss
Mm, Mm, Mm, Mm, Mm, Mm, Hh, Hh, Gs, Gs, Ww, Ww, Gg, Gs^Efm, Gs^Efm, Re, Hh, Hh, Hh, Hh, Hh, Gs^Vh, Re, Ss, Ss, Ss, Ss, Ss, Ss^Vhs, Gg, Ww, Gs, Gg, Ss, Ss, Hh, Hh, Mm, Mm, Mm^Xm, Mm, Mm, Mm, Mm, Hh, Gg, Re, Ss, Ss, Ss
Mm, Mm, Mm, Mm, Mm, Hh, Hh, Gg, Gg, Gg^Es, Ww, Gg, Gg, Gg^Efm, Re, Re, Gg, Hh, Mm, Mm, Hh, Gg, Re, Ss, Ss, Ss, Ss, Ss, Ww, Ww, Ww, Ss, Ss, Ss, Ss, Hh, Hh, Hh, Mm, Mm, Mm, Mm, Mm, Hh, Gs, Re, Ss, Ss, Ss, Ss
Mm, Mm, Mm, Mm, Mm, Mm, Mm, Hh, Hh, Gg, Ww, Ww, Ss, Ss, Re, Gg, Ss, Hh, Hh, Hh, Hh, Gg, Re, Gg, Gs, Ss, Ss, Ss, Ss^Vhs, Ww, Ww, Ww, Ww, Hh, Hh, Hh, Mm, Mm, Hh, Hh, Hh, Hh, Hh, Hh, Gs, Re, Ss, Ss, Ss, Ss
Mm, Mm, Mm, Mm, Hh, Mm, Hh^Edt, Hh, Re^Edt, Gg, Ww^Bw/, Chw, Chw, Re, Ss, Ss, Ss, Ss, Hh, Hh, Hh, Gg, Re, Gg, Gs, Gg, Ss, Ss, Ss, Gs^Fp, Ss, Ww, Ss, Hh, Hh, Hh, Hh, Hh, Hh, Hh, Hh, Hh, Hh, Hh, Gs^Efm, Re^Es, Gg, Ss, Ss, Ss
Mm, Mm, Hh, Hh, Hh, Hh, Re^Edt, Re^Edt, Cer^Edt, Re, Ss^Vhs, Ww, Ww, Ww, Ww, Ss, Gs^Fp, Ss, Ss, Ss, Ss, Ss, Gg, Re, Re, Gs, Gg, Ss, Ss, Ss, Ss, Ss, Ss, Hh, Hh, Mm, Hh, Hh, Gg, Gg, Hh, Hh, Gg, Gg^Efm, Gg^Efm, Re, Sm, Ss, Ss, Gg
Mm, Mm, Hh, Hh, Hh, Ker^Edt, Cer^Edt, Cer^Edt, Cer^Edt, Ss, Ww, Ww, Wo, Wo, Ww, Ww, Gs^Fp, Gs^Fp, Gs^Fp, Gs^Fp, Ss, Ss, Ss, Ss^Vhs, Ww^Bw|, Gg, Gg, Ss, Ss, Ss, Ss, Ss, Ss, Ss, Hh, Hh, Hh, Hh, Ss, Ss, Hh, Hh, Hh, Ss, Re, Re, Sm, Gg, Gg, Gg
Mm, Mm, Hh, Hh, Gs^Fds, Ss, Gg, Cer^Edt, Ss, Ww, Ww, Ww, Wo, Wo, Ww, Ww, Ss, Gs^Fp, Gs^Vh, Gs^Fp, Gs^Fp, Gs^Fp, Ss, Ss, Re, Ss, Ss, Ss, Ss, Ss, Ss, Ss, Ss, Ss, Ss, Ss, Ss, Gg, Ss, Ss, Hh, Hh, Ss, Ss, Ss, Sm^Bw\, Re, Sm, Sm, Gg
Mm, Hh, Gs^Fds, Hh, Gs^Fds, Ss, Ss, Gg, Ss^Vhs, Ww, Ww, Ww, Wo, Wo, Ww, Ww, Ww, Gs^Fp, Gs^Fp, Gs^Fp, Gs^Fp, Gs^Fp, Ss, Ss, Re, Gg, Ss, Ss, Ss, Gs^Fp, Gs^Fp, Ss, Gs^Fp, Ss, Ss, Ss, Ss, Ss, Ss, Ss, Ss^Vhs, Ss, Ss, Ss, Ss, Sm, Sm, Re, Gg, Sm
Mm, Gll^Feth, Gs^Fds, Gs^Fds, Hh, Gs^Fds, Ss, Ww, Ww, Ww, Ww, Ww, Wo, Wo, Ww, Ww, Ww, Ss, Gs^Fp, Gs^Fp, Gs^Fp, Gs^Fp, Ss, Ss, Gg, Re, Ss, Gs^Fp, Gs^Fp, Gs^Fp, Gs^Fp, Gs^Fp, Gs^Fp, Ss, Ss, Ss, Ss, Gs^Fp, Ss, Ss, Ss, Ss, Ss, Ss, Ss, Sm, Sm, Gs^Vh, Gg, Gg
Mm, Mm, Mm, Hh, Hh, Hh, Ss, Ww, Ww, Ww, Ww, Wo, Wo, Ww, Ww, Ww, Ss, Ss, Gs^Fp, Gs^Fp, Gs^Fp, Gs^Fp, Ss, Ss, Re, Re, Ss, Gs^Fp, Gs^Vh, Gs^Fp, Gs^Fp, Gs^Fp, Ss, Ss, Ss, Ss, Gs^Fp, Gs^Fms, Gs^Fp, Gs^Fp, Gs^Fp, Gs^Fp, Ss, Ss, Ss, Ww, Sm, Ww, Ss, Gg
Mm^Xm, Mm^Xm, Mm, Mm, Mm, Mm, Hh, Ww, Ww, Ww, Wo, Wo, Ww, Ww, Ww, Ss, Gg, Gg, Ss, Gs^Fp, Ss, Ss, Ss, Re, Gg, Gg, Ss, Gs^Fp, Gs^Fp, Ww, Ww, Ss, Sm, Ss, Ss, Ss, Ss, Gs^Fp, Gs^Fp, Gs^Fp, Gs^Fp, Ss, Ss, Ss, Ww, Ww, Ww, Gs^Fp, Gs^Fp, Ss
Mm^Xm, Mm^Xm, Mm^Xm, Mm, Hh, Hh, Ss, Ww, Ww, Ww, Wo, Ww, Ww, Ww, Ss, Ss, Ss, Ss, Ss, Ss, Ss, Gg, Re, Re, Sm, Sm, Sm, Gs^Fp, Gs^Fp, Gs^Fp, Ss, Ss, Sm, Gg, Gg, Gg, Ss, Ss, Ss, Ss, Ss, Ss, Ss, Ss, Ww, Ww, Ww, Gs^Fp, Gs^Fp, Ss
Mm^Xm, Mm^Xm, Mm, Mm, Hh, Ss, Ss, Gs^Vh, Ww, Ww, Ww, Ww, Ww, Ww, Ss, Ss, Ss, Ss, Ss, Ss, Ss, Gg, Re, Ss, Sm, Sm, Sm, Sm, Ss, Ww, Ss, Sm, Sm, Sm, Gs, Gg^Dr, Gg, Gg, Ss, Ss, Ss, Ss, Gs^Fds, Ww, Ww, Ww, Gs^Fp, Gs^Fp, Gs^Fp, Ss
Mm, Mm^Xm, Mm, Hh, Ss, Ss, Ss, Ss, Ss, Gg, Ww, Gs^Vh, Gg, Gg, Ss, Gs^Fp, Ss, Ss, Ss, Ss, Ss, Ss^Vhs, Re, Ss, Ss, Sm, Sm, Sm, Ss, Ss, Ss, Sm, Sm, Sm, Gs^Efm, Gs^Efm, Gg^Efm, Ss, Ss, Gg, Gg, Gs^Fds, Gs^Fds, Ww, Ww, Ww, Gs^Fp, Gs^Fp, Gs^Fp, Ss
Mm, Mm, Mm, Hh, Ss, Ss, Gs^Fp, Ss, Ss, Gg, Gg, Gg^Es, Gg, Gg, Ss, Ss, Ss, Ss, Ss, Ss, Ss, Ss, Ww^Bw|, Ss, Ss, Sm, Gs^Fms, Ss, Ss, Ss, Ss, Gg, Ss, Ss, Ss, Gg^Efm, Gg, Ss, Ss, Gg, Gg, Gs^Fds, Ww, Gg^Fet, Ww, Ww, Ss, Gs^Fp, Ss^Vhs, Ss
Mm, Mm, Mm, Hh, Hh, Ss, Hh, Gs^Fp, Ss, Ss, Ss, Gg, Gg, Gg, Ss, Ss, Ss, Ss, Ss, Ss, Ss, Ss, Re, Ss, Gs^Fms, Gs^Fms, Gs^Fms, Ss, Ss, Ss, Ss, Ss, Ss, Ss, Ss, Ss, Ss^Vhs, Ss, Ss, Gg, Ker^Edt, Gg^Edt, Gg^Edt, Ww, Ss, Ss, Ss, Ss, Ss, Gg
Mm, Mm, Hh, Hh, Hh, Hh, Gs^Fp, Gs^Fp, Ss, Ss, Ss, Ss, Gg, Ss, Ss, Ss, Ss, Hh, Hh, Ss, Ss, Gg, Re, Ww, Ww, Gs^Fms, Ww, Gs^Fp, Ss^Vhs, Ss, Ss, Ss, Gg, Ss, Ss, Ss, Ss, Ss, Ss, Ss^Edt, Cer^Edt, Ss, Ss^Edt, Ss, Ss, Ss, Ss, Ss, Gg, Hh
Hh, Hh, Hh, Ss, Ss, Ss, Gs^Fp, Gs^Fp, Ss, Ss, Ss^Vhs, Hh, Ss, Ss, Mm, Hh, Mm, Mm, Mm, Ss, Ss, Gg, Re, Ww, Ww, Ww, Ss, Ss, Ss, Ss, Ss, Ss, Gg, Ss, Ss, Ss, Ss, Ss, Ss, Cer^Edt, Cer^Edt, Cer^Edt, Ss^Edt, Gs^Fp, Gs^Fp, Gs^Fp, Ss, Ss, Hh, Hh
Hh, Hh, Ss, Ss, Ss, Ss, Gs^Fp, Gs^Fp, Gs^Fp, Gs^Fp, Ss, Hh, Hh, Hh, Mm, Mm, Mm^Xm, Mm^Xm, Mm, Ss, Ss, Re, Ss, Ww, Ww, Ww, Ss, Ss, Ss, Ss, Gs^Efm, Gs, Gg^Es, Ss, Ss, Ss, Ss, Ss, Gg, Cer^Edt, Gs^Fms, Cer^Edt, Ss, Gs^Fp, Gs^Fp, Ss, Ss, Ss, Gg, Hh
Hh, Hh, Ss, Ss, Ss, Ss, Gs^Fp, Gs^Fms, Gs^Fp, Gs^Fp, Ss, Ss, Hh, Ss, Ss, Mm, Mm, Mm^Xm, Mm, Ss, Ww^Bw/, Chs, Ss, Ww, Ww, Ww, Ss, Ss, Ss, Ss, Gs^Efm, Gs^Efm, Sm, Gg, Ss, Ss, Ss, Gg, Gs, Gs^Fms, Gs^Fms, Gs^Fms, Ss, Gs^Fp, Gs^Fp, Ss, Ss, Ss, Hh, Hh
Hh, Hh, Gg, Gg^Efm, Gg^Efm, Ww, Ww, Ww, Gs^Fp, Gs^Fp, Gs^Fp, Ss, Ss, Ss, Ss, Ss, Hh, Mm^Xm, Hh, Re, Ss, Ss, Ss, Ss^Vhs, Ww, Ww, Ss, Ss, Ss, Sm, Sm, Sm, Sm, Gg, Gg, Ss, Gs, Gs, Gg, Ww, Ww, Ww, Ww, Gg, Gs^Efm, Ss, Ww, Ww, Ww, Ww
Hh, Hh, Gg, Gg^Efm, Gg^Efm, Gg^Efm, Ww, Ww, Gs^Fp, Gs^Fp, Gs^Fp, Gs^Fp, Ss, Ss, Ss, Ss, Gg, Gg, Gs^Vh, Re, Gg, Ss, Ss, Gg, Ss, Ss, Ss, Ss, Ss, Ss, Gg, Sm, Sm, Sm, Gg, Gs, Ss, Gs, Ww, Ww, Ww, Ww, Ww, Gs^Efm, Gs^Efm, Gs^Efm, Ww, Ww, Ww, Ww
Hh, Hh, Gg, Gg, Ss, Ww, Gs^Fp, Gs^Fp, Gs^Fp, Gs^Fp, Gs^Fp, Ss, Ss, Ss, Gg^Efm, Gg^Efm, Gg^Efm, Gg^Es, Gg, Re, Ce, Ce, Ce, Gg, Gg, Ss, Ss, Ss, Ss, Ss, Gg, Gg, Sm, Sm, Ss, Ss, Ss, Ss, Gg, Gs^Fms, Gs^Fms, Gs^Fms, Gg, Gs^Efm, Gs^Dr, Gs, Ww, Ww, Ww, Ww
Ss, Ss^Vhs, Ss, Gg, Ss, Gs^Fp, Gs^Fp, Gs^Fms, Gs^Fp, Ww, Ss, Ss, Ss, Ss, Ss, Gg^Efm, Gg^Efm, Gg^Efm, Gg, Re, Ce, Ke, Ce, Gg, Gg, Ss, Ss, Ss, Gs^Fp, Ss, Gg, Gg, Hh, Hh, Ss, Ss, Ss, Ss, Ss, Ss, Gg, Gg, Gg, Gs, Gs, Gs, Gg, Gg, Sm, Sm
Ss, Ss, Hh, Ss, Ss, Ss, Gs^Fp, Gs^Fp, Gs^Fp, Gs^Fp, Ss, Ww, Ss, Ss, Ss, Ss, Ss, Ss, Gg, Re, Gg, Ce, Re, Gg, Gg, Ss, Ss, Gs^Fp, Ss, Ss^Vhs, Ss, Hh, Mm^Xm, Hh, Hh, Ss, Ss, Ss, Ss, Ss, Gg, Gg, Ss, Ss, Ss, Gg, Sm, Sm, Sm, Sm
Hh, Hh, Hh, Hh, Ss, Ss, Ss, Gs^Fp, Gs^Fp, Gs^Fp, Ww, Ww, Ww, Ss, Ww, Ww, Ww, Ss, Gg, Re, Re, Re, Gg, Re, Re, Ss, Ss, Ss, Ss, Ss, Hh, Hh, Mm^Xm, Mm^Xm, Mm^Xm, Hh, Hh, Ss, Ss, Ss, Ss, Gg, Ss, Ss, Ss, Gg, Sm, Sm, Sm, Sm
