Gll^Fp, Gll^Fp, Gg, Ds, Wwg, Wwg, Wwg, Wo, Wo, Wo, Wo, Wo, Wo, Wo, Wo, Wo, Wo, Wo, Wwg, Wwg, Mm, Mm, Hh, Re, Gg^Edt, Gg, Gg, Gg, Gg, Gll^Fp, Gll^Fp, Gll^Fp, Gll^Fp, Gll^Fp, Gll^Fp, Gd, Gll, Gll^Qhu, Wwg, Wwg, Wwg, Wwg, Ss, Wwg, Wwg, Wwg, Ss, Wwg, Ss, Ss, Ss, Sm, Ss, Ss, Ss, Ss, Ss, Ss, Ss, Gll, Wwg, Gg, Gll^Qhux
Gll^Fp, Gll^Fp, Gll^Fp, Ds, Ds, Wwg, Wwg, Wwg, Wwg, Wo, Wo, Wo, Wo, Wo, Wo, Wo, Wo, Wo, Wwg, Wwg, Mm, Mm, Hh, Re, Gg^Edt, Gg, Cer^Edt, Gg^Edt, Gg, Gg, Gll^Fp, Gll^Fp, Gs, Gll^Fp, Gll^Fp, Gll^Fp, Gll, Gll^Qhu, Gll, Wwg, Ss, Wwg, Ss, Ss, Ss, Wwg, Ss, Ss, Sm, Ss, Sm, Ss, Ss, Sm, Sm, Sm, Ss, Ss, Wwg, Wwg, Wwg, Ss^Qhux, Ss^Qhux
Gll^Fp, Gs, Gll^Fp, Gg, Gg, Ds, Wwg, Wwg, Wwg, Wwg, Wwg, Wo, Wo, Wo, Wo, Wo, Wwg, Wwg, Mm, Mm, Mm, Mm, Hh, Re^Edt, Cer^Edt, Cer^Edt, Ker^Edt, Cer^Edt, Gg^Edt, Gg, Gs, Gs, Gg^Es, Gs, Gd, Gll^Fp, Gll^Fp, Gll^Qhu, Ss^Vhs, Ss, Ss, Ss, Sm, Gll, Gll^Edb, Ss^Edb, Gll^Edb, Sm^Edb, Gll^Edb, Ss^Vhs, Wwg, Wwg, Ss, Ss, Ss, Ss, Sm, Wwg, Ss, Wwg, Wwg, Ss^Qhux, Ss^Qhux
Gs, Gll^Fp, Gll^Fp, Gg^Es, Gg, Ds, Ds, Wwg, Ds, Wwg, Wwg, Wo, Wwg, Wo, Wwg, Wwg, Wwg, Wwg, Mm, Mm, Hh, Hh, Re, Re, Gg^Edt, Cer^Edt, Cer^Edt, Cer^Edt, Gs^Edb, Gs, Gg, Gs, Gd, Gg, Gd, Gd, Gd, Gg^Qhu, Gll^Qhu, Ss, Ss, Ss, Gll, Sm, Sm, Gll^Edb, Sm^Edb, Sm^Edb, Gll^Edb, Gll, Wwg, Wwg, Ss, Ss, Sm, Sm, Ss^Edt, Ss^Edt, Wwg^Edt, Wwg, Ss, Ss^Qhux, Ss
Rr, Gs, Gg, Gll^Fp, Gll^Fp, Gll^Fp, Gll^Fp, Ds, Ds, Wwg, Wwg, Wwg, Wwg, Wwg, Wwg, Wwg, Ds, Ds, Gs, Hh, Re, Re, Re^Edb, Gg^Edb, Gg^Edb, Gg^Edb, Gg^Edb, Gs^Edb, Gg^Edb, Gg, Gs, Gs, Gg, Gg^Efm, Gg^Efm, Gd, Gd, Gd, Gll, Gll^Qhu, Gll^Qhu, Ss, Ss, Ss, Ss, Sm^Edb, Sm, Gll^Edb, Gll^Edb, Wwg^Edb, Wwg, Ss, Ss^Edt, Sm^Edt, Ss^Edt, Sm^Edt, Sm^Edt, Sm^Edt, Gll, Sm, Ss, Wwg, Wwg
Gs, Rr, Rr, Rr, Rr, Gll^Fp, Gs, Gs, Gs, Ds, Wwg, Wwg, Ds, Ww^Vm, Ds, Ds, Gs, Gs, Re, Re, Gs, Gs, Gs^Edb, Re^Edb, Re^Edb, Gg^Edb, Gg^Edb, Gg^Edb, Gg^Edb, Gg, Re, Gs^Vh, Gg, Gd^Efm, Gd, Gd^Efm, Gg, Gd, Gd, Gll, Gg, Gll^Qhu, Gll^Qhu, Ss, Ss, Ss, Ss, Sm, Ss, Wwg^_ml, Ss, Gll, Gll^Edt, Sm^Edt, Sm^Edt, Sm^Edt, Sm^Edt, Gll^Edt, Ss^Edt, Ss, Sm, Ss^Qhux, Ss
Gll^Fp, Gll^Fp, Gll^Fp, Rr, Gll^Fp, Rr, Rr, Gs, Gs, Wwg, Gs, Ds, Gs, Ds, Gg, Gg, Re, Re, Gs, Gg, Gg, Gg, Gg, Gg^Edb, Gg, Re^Edb, Re^Edb, Gs, Re, Re, Gs, Gs, Gs^Qhhf, Gg, Gg^Qhhf, Gg, Gd^Qhhf, Gs, Gs, Gs, Gd, Gg, Gll, Gll^Qhu, Gll, Ss, Ss, Sm, Ss, Ss, Ss^Edt, Ss^Edt, Gll^Edt, Gll^Edt, Ss^Edt, Ss^Edt, Gll^Edt, Gll^Edt, Ss, Ss, Sm^Qhux, Ss^Qhux, Ss
Gll^Fp, Gll^Fp, Gll^Fp, Gll^Fp, Gll^Fp, Gll^Fp, Gs, Rr, Wwg^Bsb\, Wwg, Gs^Efm, Gs^Efm, Gs, Gs^Es, Rr, Re, Gg, Gg, Gs, Gg, Gg, Gg^Es, Gg, Gg, Gg, Gs^Edb, Gs^Efm, Re, Gll^Fp, Gs, Gll^Fp, Gs, Gll^Qhhf, Gs^Qhhf, Gll^Fp, Gg^Qhhf, Gg, Gg, Gll^Fp, Gg, Gd^Es, Gd, Gd, Gll^Qhu, Gll^Qhu, Ss, Ss, Ss, Ss, Ss, Ss^Edt, Ss^Edt, Gll^Edt, Gll^Edt, Ss^Edt, Ss^Edt, Ss, Ss, Ss, Sm, Sm, Ss^Qhux, Ss^Qhux
Gg, Gll^Fp, Gg, Gll^Fp, Gll^Fp, Gll^Fp, Wwg, Wwg, Ce, Rr, Rr, Gs^Efm, Rr, Rr, Gs, Gg, Gg, Gg, Gs^Efm, Gs^Efm, Gg^Efm, Gg, Gg, Gg^Ecf, Gs, Gs^Efm, Gs^Efm, Gs, Gs, Gll^Fp, Gg, Gll^Fp, Gll^Fp, Gll^Fp, Gll^Fp, Gll^Fp, Gg, Gll^Fp, Gll^Fp, Gg, Gg, Gg, Gd, Gg^Qhu, Gd^Qhu, Gll, Gll, Gll, Gll, Ss, Ss, Gll^Edt, Ss^Edt, Ss, Gll^Edt, Gll^Edt, Ss, Sm, Ss, Ss^Vhs, Ss, Ss, Ss
Gg, Gg, Gg, Gg, Wwg, Wwg, Wwg, Wwg, Gg, Gs, Gs, Rr, Gg, Rr, Rr, Gg, Gg, Gg, Gs^Efm, Gs^Efm, Gg^Efm, Gg^Efm, Ce, Gg, Gg, Ce, Ce, Gs, Gs, Gs, Gs, Gll^Fp, Gg, Gll^Fp, Gs, Gg, Gg, Gg, Gg, Gll^Fp, Gg, Gd^Es, Gd, Gd, Gd, Gg^Qhu, Gll, Gll, Ss, Ss, Ss, Gll^Edt, Ss^Edt, Ss^Edt, Gll, Gll, Ss^Edt, Ss, Ss, Ss, Wwg, Ss, Ss
Gg, Gg, Wwg, Wwg, Wwg, Wwg, Gs, Wwg, Gg, Gs, Gg, Re, Gg, Gg, Gg, Rr, Rr, Rr, Rr, Gs, Gg, Ce, Rr, Gg, Rr, Gg, Gg, Gs, Gg, Ce, Gs, Gs, Gs, Gs, Gs, Gs^Ecf, Re, Gs^Vh, Gg, Gg, Gg, Gg, Gg, Gd, Gd, Gll^Qhu, Gll, Ss, Ss, Ss, Ss, Ss, Ss, Ss, Ss, Gll^Edt, Ss^Edt, Wwg, Wwg, Wwg, Wwg, Wwg, Ss
Wwg, Wwg, Gg, Gg, Gg^Es, Gg, Gs, Wwg, Wwg, Gg, Ce, Re, Gg, Gg, Gg, Gg^Ecf, Gg, Gg, Ce, Rr, Rr, Rr, Gg^Ebn, Rr, Rr, Rr, Ch^Qhh, Gg, Gg, Gg, Gg, Re^Vct, Gg^Efm, Ce, Ce, Re, Gg, Gg, Gll^Fp, Gll^Fp, Gll^Fp, Gg, Gg, Gd, Gd, Gll^Qhu, Gll^Qhu, Ss, Ss, Ss, Ss, Ss, Ss, Ss, Gll, Ss^Edt, Sm, Ss, Wwg, Wwg, Ss, Wwg, Wwg
Gg, Gg, Gg^Edb, Gg^Edb, Cer^Edb, Gs, Gs, Gg, Gg, Wwg, Wwg, Re, Gg, Gg, Gg, Gg, Gg, Ce, Gs, Rr, Gs^Ebn, Rr, Rr, Rr, Ch^Qhh, Rrc^Qhh, Rrc, Ch^Qhh, Ch^Qhh, Gg, Gg, Gg, Gg^Efm, Gg^Efm, Gg, Re, Gg, Gll^Fp, Gll^Fp, Gg^Fet, Gll^Fp, Gg, Gg, Gd^Efm, Gd^Efm, Gd, Gd, Gll^Qhu, Gll^Qhu, Gll, Gll, Ss, Ss, Gll, Ss, Ss, Sm, Ss, Ss, Wwg, Wwg, Ss, Wwg
Gg, Gg, Cer^Edb, Cer, Cer, Cer^Edb, Gg^Edb, Gg, Gs, Gg, Gg, Wwg^Bw|, Wwg, Gg, Gg, Gg^Es, Gs, Gs, Gg, Rr, Rr, Rr, Ch^Qhh, Rrc^Qhh, Rrc, Rrc, Rr^Vhc, Rrc, Rrc, Ch^Qhh, Ch^Qhh, Gg, Gg^Efm, Gg^Efm, Gg, Re, Ce, Gg, Gg, Gll^Fp, Gll^Fp, Gll^Fp, Gg, Gd^Efm, Gd^Efm, Gd, Gd, Gll^Qhu, Gd, Gll^Qhu, Gll, Ss, Ss, Ss, Ss, Ss, Sm, Ss, Sm, Ss, Sm, Sm, Ss
Gg, Gg^Edb, Cer^Edb, Ker^Edb, Cer^Edb, Cer^Edb, Gg^Edb, Gg^Edb, Gg, Gs, Gs, Re, Gg, Wwg, Gg, Re^Vct, Gg, Gg, Gg, Rr, Rrc^Qhh, Ch^Qhh, Rrc, Rrc, Ch, Rrc, Rrc, Rrc, Rr^Vhc, Rrc, Ch^Qhh, Gg, Gg, Gg, Gg, Re, Ce, Gg^Ecf, Gg^Es, Gg, Gll^Fp, Gll^Fp, Gll^Fp, Gg^Efm, Gg, Gd, Gd, Gd, Gd, Gll^Qhu, Gll^Qhu, Ss, Ss, Ss, Cer^Edb, Ss, Ss, Sm, Ss, Sm, Sm, Sm^Qhux, Ss
Gs, Gg, Gs^Edb, Cer^Edb, Re^Edb, Re^Edb, Re^Edb, Gs^Edb, Gs^Edb, Gs, Re, Re, Gg, Wwg, Gg, Gg, Gg, Gg, Gg, Ch^Qhh, Rrc, Rrc, Rr^Vhc, Rrc, Rrc, Ch, Ch, Rrc, Rrc, Rrc, Ch^Qhh, Gg, Gs, Re^Vct, Gg, Re, Gs, Gs, Gs, Gg, Gs, Gll^Fp, Gll^Fp, Gll^Fp, Gll^Fp, Gll^Fp, Gg^Qhhf, Gd^Es, Gd, Gd, Gd^Qhu, Gll, Gll^Edb, Gll^Edb, Ss^Edb, Cer^Edb, Cer, Gll, Gll, Ss, Ss, Ss^Qhux, Ss^Qhux
Gs, Gg^Edb, Re^Edb, Re^Edb, Gg^Edb, Gs^Edb, Gg^Edb, Re^Edb, Re, Re, Gg, Gg, Gg, Wwg, Gg^Efm, Gg, Gg, Gg, Gg, Ch^Qhh, Rrc, Rrc, Ch, Rrc, Ch, Ch, Ch, Rrc, Rr^Vhc, Rrc, Ch^Qhh, Gs, Gs, Gg, Gg, Re, Gs, Gs, Gg^Efm, Gs, Gs, Gs, Gll^Fp, Gll^Fp, Gg, Gg^Qhhf, Gg^Qhhf, Gd^Qhhf, Gd^Qhhf, Gd, Gd, Gll^Qhu, Gll^Edb, Gll^Edb, Ss^Edb, Cer^Edb, Ss^Edb, Cer^Edb, Ker, Ss, Ss^Vhs, Ss^Qhux, Ss^Qhux
Re, Re, Gs, Gs, Gg, Gg, Gg, Gg, Gg, Gg, Gg^Efm, Gg^Efm, Gg^Efm, Wwg, Gg^Efm, Gg^Efm, Gs^Efm, Gg, Gs, Ch^Qhh, Rrc, Rrc, Ch, Kh, Rrc, Rrc, Ch, Rrc, Rrc, Rrc, Ch^Qhh, Gs, Gs, Gs, Gs, Re, Gs, Gg, Gg, Gs^Efm, Gg^Efm, Gs, Gg, Gg, Gg^Es, Gg^Qhhf, Gg, Gd^Qhhf, Gd^Qhhf, Gd, Gd, Gll^Qhu, Gll, Ss^Edb, Ss^Edb, Cer^Edb, Cer^Edb, Cer^Edb, Ss, Ss, Ss, Ss, Ss^Qhux
Gs, Gg, Gll^Fp, Gg, Gs^Fds, Gg, Gg^Es, Gg, Gg^Efm, Gg^Efm, Gg, Gg^Efm, Gg, Wwg, Gs, Gs^Efm, Gs, Gs, Gs, Ch^Qhh, Rrc, Rr^Vhc, Rrc, Ch, Rr^Vhc, Rrc, Rrc, Rrc, Ch^Qhh, Rrc^Qhh, Rr, Gs, Gs, Gg, Re, Re, Re, Gg, Gg, Gg^Efm, Gg, Gg^Efm, Ce, Gg, Gs, Gg, Gg, Gg^Es, Gg, Gg, Gd, Gll^Qhu, Gll, Ss, Cer^Edb, Cer^Edb, Gll^Edb, Gll^Edb, Sm, Ss, Sm^Qhux, Sm, Ss^Qhux
Gs, Gll^Fp, Gll^Fp, Gll^Fp, Gs^Fds, Gg, Gg, Gg, Gs^Fds, Gg, Gs^Fds, Gg, Gg, Wwg, Gs, Gs, Gs, Gg, Gs, Ch^Qhh, Ch^Qhh, Rrc, Rrc, Rrc, Rrc, Rrc, Ch, Rrc^Qhh, Rr, Rr, Rr, Gs, Re, Re, Gg^Eqf, Gg^Eqf, Gg^Eqf, Re, Re, Gg, Gg, Gg^Efm, Ce, Gs, Gg^Ecf, Gs, Gs, Gg, Gd, Gd, Gll^Qhu, Gll^Qhu, Gll, Ss, Ss, Ss, Ss, Sm^Edb, Ss, Sm, Sm^Qhux, Sm^Qhux, Ss^Qhux
Gg, Gs^Fds, Gll^Fp, Gll^Fp, Gg, Gs^Fds, Gs^Vl, Gg, Gs^Fds, Gs^Fms, Gs^Fms, Gs^Fds, Gs^Fms, Wwg, Gg, Gs, Gs, Gs, Gs, Gs, Gs, Ch^Qhh, Ch^Qhh, Rrc, Rrc^Qhh, Ch^Qhh, Rr, Rr, Rr, Gs^Ebn, Rr, Rr, Gg^Eqf, Gg^Eqf, Gg, Gg^GrvS, Urc, Gg^Eqf, Gg^Eqf, Re, Re, Gg, Gg, Gg, Gs, Gg, Gg, Gg, Gg, Gd, Gll^Qhu, Gll, Gll, Gll, Gll, Ss, Ss, Sm, Wwg, Ss, Ss, Ss^Qhux, Ss^Qhux
Gll^Fp, Gs, Gll^Fp, Gll^Fp, Gs^Fds, Gs^Fds, Gs^Fds, Gs^Fds, Gs^Fms, Gs^Fms, Gs^Fds, Gs^Fds, Gs^Fms, Wwg, Gs^Fds, Gs^Fds, Gg, Gs, Gs, Gs, Gs, Gg, Gs, Ch^Qhh, Gg, Rr, Rr, Gg^Ebn, Rr, Rr, Gg^Eqf, Rr, Gg, Gg^GrvS, Urc, Gg, Gg, Gg^GrvS, Urc, Gg^Eqf, Gs^Eqf, Re, Gs^Vh, Gg, Gs, Gs, Gs, Gs, Gd, Gd, Gll^Qhu, Gll, Ss, Ss, Ss, Ss^Vhs, Ss, Ss, Wwg, Wwg, Ss, Ss^Qhux, Ss
Gll^Fp, Gll^Fp, Gll^Fp, Gs^Fds, Gs^Fds, Gg, Gs, Gs^Fds, Gs^Fms, Gs^Fds, Gs^Fds, Gs^Fds, Wwg, Wwg, Wwg, Gs^Fds, Gs^Fds, Gg, Re^Vct, Gg, Gs, Gs, Gs, Gg, Gg, Gg, Gg, Rr, Rr, Gg^Eqf, Gg^Eqf, Gg^GrvS, Urc, Gg, Gg, Gg^GrvS, Urc, Gg, Gg^Eqf, Gs^Eqf, Gs, Gg, Gs, Gg, Gg, Gg, Gg, Gd, Gd, Gll^Qhu, Gll, Gll, Ss, Ss^Qhux, Ss^Qhux, Ss, Ss, Ss, Ss, Wwg, Wwg, Ss, Ss
Gll^Fp, Gll^Fp, Gll^Fp, Gll^Fp, Gs^Fds, Gs^Fds, Gs^Fds, Gs^Fds, Gs^Fds, Gs^Fds, Wwg, Wwg, Gs^Fms, Gs^Fms, Gs^Fds, Wwg, Wwg, Gg, Gs, Gg, Gg, Gg, Gg, Gg, Gg, Gg, Gg, Gg, Rr, Gg, Gg, Gg^Eqf, Gg^Eqf, Gg^GrvS, Urc, Gg, Gg^Eqf, Gs^Eqf, Gs, Gs, Gg, Gs, Gs, Gg, Gg, Gg, Gg^Es, Gd, Gd, Gll^Qhu, Gll, Ss, Ss^Qhux, Ss^Qhux, Ss, Ss, Ss, Ss, Ss, Wwg, Wwg, Wwg, Wwg
Gs^Fds, Gs^Fds, Gs^Fds, Gll^Fp, Gs^Fds, Gg^Fet, Gs^Fds, Gs^Fds, Wwg, Wwg, Gs^Fms, Gs^Fds, Gs^Fds, Gs^Fms, Gs^Fds, Gs^Fms, Gs^Fds, Wwg, Wwg, Wwg, Wwg, Gg, Wwg, Wwg, Wwg, Gs, Gg, Gg, Rr, Gg, Gg, Gg, Gg, Gs^Eqf, Gg^Eqf, Gg^Eqf, Gg, Gs, Gg, Gs^Es, Gs, Gs, Gs, Gg, Gg, Gg, Gd, Gd, Gd, Gll^Qhu, Gll, Ss, Ss^Qhux, Ss^Qhux, Gll, Gll^Edt, Gll^Edt, Ss, Gll, Ss, Ss, Ss, Ss
Gg, Gg, Gg, Gll^Fp, Gs^Fds, Gs^Fds, Gll^Fp, Gs^Fds, Wwg, Gs^Fds, Gs^Fms, Gs^Fms, Gs^Fms, Gs^Fds, Gg, Gs^Fds, Gg, Gs^Fds, Gg, Gg, Gg, Wwg, Wwg, Wwg, Wwg, Gg, Gg, Gg, Rr, Gg, Gg, Gg, Gs, Gg, Gg, Gg, Gg^Efm, Gs, Gs^Efm, Gs, Gs, Gs, Gs^Efm, Gg, Gg, Gg, Gg, Gd, Gd, Gll^Qhu, Gll, Ss, Ss, Ss, Gll, Gll^Edt, Gll^Edt, Ss, Gll, Ss, Gll, Gll, Ss
Gg, Gg, Gg, Gs^Fds, Gs^Vl, Gs^Fds, Gs^Fds, Gs^Fds, Wwg, Gs^Fms, Gs^Fms, Gs^Fms, Gg, Gs^Fds, Gs, Gg, Gg^Qhh, Gg^Qhh, Gg^Qhh, Gg, Gg, Gg, Wwg, Wwg, Wwg, Wwg, Ce, Gg, Rr, Gg, Gs, Gs, Ce, Gs^Es, Gs, Gg, Gg^Qhh, Gg^Qhh, Gg^Qhh, Gs^Efm, Gs^Efm, Gs^Efm, Gs, Gs, Gs, Gg, Gg, Gg, Gd, Gd^Qhu, Gg, Gll, Gll, Gll, Gll^Edt, Gll^Edt, Ss^Edt, Ss, Sm, Ss, Gll, Sm, Ss
Gg, Gg, Gg, Gg, Gg, Gg, Gg, Gs^Fds, Wwg, Gs^Fms, Gs^Fms, Gs, Gg, Gs, Gg^Qhh, Gs^Qhh, Re, Gg, Gg, Gg^Qhh, Gs^Qhh, Gs^Qhh, Gs^Qhh, Gs, Gg, Gg, Gg, Ce, Rr, Gg, Gg, Ce, Gs, Gs, Gs^Qhh, Gg^Qhh, Gg^Efm, Gg, Gg^Efm, Gs^Qhh, Gs^Qhh, Gg^Qhh, Gg^Qhh, Gg^Es, Gs, Gg, Gg, Gg, Gd, Gd^Qhu, Gd^Edt, Gll^Edt, Ss^Edt, Gll, Gll^Edt, Ss^Edt, Ss, Sm, Sm, Sm, Gll, Sm, Ss
Gg, Gg, Gg, Gs, Wwg, Gg, Wwg, Wwg, Gg^Qhh, Gg^Qhh, Gg^Qhh, Gg, Gg^Qhh, Gg^Qhh, Re, Re, Gg, Re, Re, Re, Re, Gg^Qhh, Gs, Gg^Qhh, Gs^Qhh, Gg, Gg, Gg, Rr, Gg^Ecf, Gs, Gs^Es, Gg^Qhh, Gs^Qhh, Gg, Gg, Re, Gg^Efm, Gg, Gg, Gg^Es, Gs^Qhh, Gs^Qhh, Gs, Gg^Efm, Gg^Efm, Gd^Efm, Gd, Gd, Gd^Qhu, Gd^Edt, Ss^Edt, Ss, Ss, Gll, Ss, Ss, Ss, Sm, Sm, Ss, Sm, Ss
Gs, Gs, Wwg, Wwg, Wwg, Wwg, Gg^Qhh, Gg^Qhh, Gg, Gg, Gg, Gg^Qhh, Re, Re, Gg, Gg, Gg, Gg, Gg^Eff, Gg, Gg, Re, Re, Gs, Gs^Es, Gs^Qhh, Gs^Qhh, Gg, Rr, Gg, Gs^Qhh, Gs^Qhh, Gg, Gs, Re, Re, Gs, Re, Re, Gg, Gg, Gg, Gg, Gg^Qhh, Gg, Gg^Efm, Gd, Gd, Gg^Qhu, Gd^Qhu, Gll^Edt, Gll^Edt, Gll^Edt, Ss^Vhs, Gll, Ss, Ss, Ss, Ss, Sm, Ss, Ss, Ss
Wwg, Wwg, Gg, Gs, Wwg, Gg^Qhh, Gg, Gs^Vh, Re^Edb, Gg^Es, Re, Re^_mhh, Gg, Gs, Gs, Gg^Es, Gs^Eff, Gg^Eff, Gg^Vwm, Gg^Eff, Gg^Eff, Gg, Gg, Re, Re, Gs, Gg, Gg^Qhh, Rr^Qhh, Gg^Qhh, Re, Re, Re, Re, Gg, Gs, Gg, Gg, Gg, Gs^Vh, Gs, Gg, Gg^Es, Gg^Qhh, Gg^Qhh, Gd, Gd, Gd, Gll^Qhu, Gll, Ss^Edt, Gll^Edt, Gll, Gll, Gll, Gll, Gll, Gll, Ss, Ss, Gll, Ss, Ss
Gg, Gs, Gg^Efm, Gs, Wwg, Gg^Qhh, Gg, Gg^Edb, Gg^Edb, Re^Edb, Gg^Edb, Gg, Gs, Gs, Gg^Eff, Gs^Eff, Rb^Gvs, Rb^Gvs, Rb^Gvs, Rb^Gvs, Rb^Gvs, Gg^Eff, Gg^Eff, Gg, Gg, Re, Re, Gg, Rr, Re, Gg, Gg, Gg, Gg, Gg, Gs, Gs, Gg, Gg, Gg, Gs, Gg, Gg, Gg, Gd^Qhhf, Gd, Gll^Qhu, Gll^Qhu, Gll, Ss, Ss^Qhux, Ss^Edt, Ss^Qhux, Ss, Ss, Gll, Gll, Gll, Ss, Gll, Gll, Gll, Ss
Gg, Gs^Efm, Gg, Gs, Wwg, Gg^Qhh, Gg^Edb, Gg^Edb, Gg^Edb, Re^Edb, Gs, Gg, Gs^Eff, Gg^Eff, Rb^Gvs, Rb^Gvs, Rb^Gvs, Rb^Gvs, Rb^Gvs, Rb^Gvs, Rb^Gvs, Rb^Gvs, Rb^Gvs, Gg^Eff, Gg^Eff, Gg, Gg, Rr, Gg, Gg, Gg, Gg, Gg^Es, Gg, Gg, Gg^Efm, Gs^Fds, Gs^Fds, Gs^Fds, Gs^Fds, Gs^Fds, Gs^Qhhf, Gg^Qhhf, Gg^Qhhf, Gd^Qhhf, Gd, Gll^Qhu, Gll, Gll, Ss^Qhux, Ss^Qhux, Ss^Qhux, Ss^Qhux, Ss^Qhux, Ss, Ss, Gll, Gll, Ss^Qhux, Ss, Ss, Gll, Ss
Gg, Gg^Efm, Gg^Efm, Gs^Efm, Wwg, Gg^Qhh, Gs^Qhh, Gs^Edb, Re^Edb, Re, Gg^Eff, Gs^Eff, Rb^Gvs, Rb^Gvs, Rb^Gvs, Rb^Gvs, Rb^Gvs, Rb^Gvs, Rb^Gvs, Rb^Gvs, Rb^Gvs, Rb^Gvs, Gg^Eff, Gg^Eff, Gg, Gg, Rr, Rr, Gg^Es, Gg, Gs^Ecf, Gg, Gs, Gg, Gg^Efm, Gs^Fds, Gs^Fds, Gg^Fet, Gs^Fds, Gs^Fds, Gs^Fds, Gs^Qhhf, Gg, Gg, Gd, Gd, Gll^Qhu, Gll, Gll, Ss, Ss, Ss, Ss, Ss^Qhux, Sm, Sm, Gll, Gll, Ss^Qhux, Ss^Vhs, Ss, Ss, Ss
Gg, Gs, Gg, Gg, Wwg, Wwg, Wwg, Gs^Qhh, Re^Qhh, Gg^Eff, Gs^Eff, Rb^Gvs, Rb^Gvs, Rb^Gvs, Rb^Gvs, Rb^Gvs, Rb^Gvs, Rb^Gvs, Rb^Gvs, Rb^Gvs, Gg, Gg^Eff, Gg, Gg, Gg, Gg^Es, Rr, Gg, Gs, Gs, Gg, Gg, Gs, Gg, Gg^Efm, Gg, Gg^Efm, Gs^Fds, Gs, Gs^Qhhf, Gs^Qhhf, Gs^Qhhf, Gg, Gd, Gd, Gll^Qhu, Gll, Gll, Ss, Ss^Edb, Gll^Edb, Gll, Sm, Ss, Sm, Sm, Ss^_ml, Ss^Qhux, Ss^Qhux, Ss^Qhux, Wwg, Ss, Wwg
Gg, Gg, Gs^Edb, Gg, Gs^Edb, Wwg, Wwg^Bw/, Wwg^Bw/, Gg^Qhh, Gs^Vh, Gs, Gs^Eff, Gs^Eff, Rb^Gvs, Rb^Gvs, Rb^Gvs, Rb^Gvs, Rb^Gvs, Gg^Eff, Gg^Eff, Gg, Gg, Gg^Efm, Gg^Efm, Gs, Gs, Rr, Gg, Re, Gs, Re, Gs^Vh, Gs, Gs, Gs^Efm, Gs^Efm, Gg^Efm, Gg, Gg^Qhhf, Gs^Qhhf, Gg^Qhhf, Gg^Qhhf, Gg, Gd, Gd, Gll^Qhu, Gll, Ss, Ss^Edb, Cer^Edb, Ker^Edb, Gll^Edb, Sm^Edb, Ss, Ss, Ss, Ss, Ss^Qhux, Ss^Qhux, Ss^Qhux, Wwg, Wwg, Ss
Gg, Gg^Edb, Ker^Edb, Cer^Edb, Re^Edb, Re, Gs, Wwg, Wwg, Gs^Qhh, Gg^Ecf, Gs, Gs, Gs^Eff, Gg^Eff, Rb^Gvs, Gs^Eff, Gg^Eff, Gg, Gg, Gg, Gg, Gg^Efm, Gs^Efm, Gg, Gg, Rr, Rr, Gg, Re, Gg, Gg, Gs, Gg, Gg^Efm, Gs^_mhh, Gs, Gg, Gg, Gg^Qhhf, Gg, Gg^Qhh, Gg^Efm, Gd^Efm, Gd, Gll^Qhu, Gll, Ss, Ss^Edb, Cer^Edb, Cer^Edb, Ss^Edb, Sm, Sm, Sm, Sm, Ss, Wwg, Ss, Wwg, Wwg, Wwg, Ss^Qhux
Re, Gg^Edb, Gg^Edb, Cer^Edb, Re^Edb, Gs, Gg^Efm, Gg, Wwg, Gg^Qhh, Gg, Gg, Gg, Gs^Efm, Gs^Efm, Gs^Eff, Gs, Gg, Gg, Gg^Es, Gg, Gg^Efm, Gg^Efm, Gg^Efm, Gg, Gg, Re^Qhh, Rr, Gg, Gg, Gg, Gg^Es, Gg, Gg, Gg, Gg, Gs, Gg, Gs^Es, Gg, Gs, Gg^Qhh, Gd^Efm, Gd^Efm, Gd, Gll^Qhu, Gll, Ss^Edb, Ss, Ss^Edb, Ss, Ss^Edb, Sm, Ss, Sm, Ss, Sm, Ss, Wwg, Wwg, Ss, Ss^Qhux, Ss^Qhux
Gg^Edb, Re^Edb, Re^Edb, Re^Edb, Gg^Efm, Gg^Efm, Gg^Efm, Gg, Wwg, Gg^Qhh, Gg^Qhh, Gg, Gg, Gg, Gg, Gs^Efm, Gg^Efm, Gg, Gg, Gg, Gg, Gg, Gg^Qhh, Gg^Qhh, Ch^Qhh, Ch^Qhh, Wwg, Rr^Qhh, Ch^Qhh, Gg, Gg^Qhh, Gg, Gg^Qhh, Gg, Gg, Gg, Gg, Gs, Gs, Gs^Efm, Gs^Efm, Gg^Qhh, Gd, Gd, Gll^Qhu, Gll^Qhu, Gll, Gll, Gll, Ss, Ss^Vhs, Ss, Wwg, Sm, Sm, Sm, Wwg, Wwg, Ss, Ss, Gll, Ss^Qhux, Ss
Gg, Gg^Edb, Gg^Edb, Gg^Edb, Gg^Efm, Gg^Efm, Wwg, Wwg, Wwg, Wwg, Wwg, Gg^Qhh, Gg, Gg^Es, Gg^Qhh, Gg, Gg^Qhh, Gg, Gg^Qhh, Gg, Gg^Qhh, Gg^Qhh, Wo, Wo, Wo, Wwg, Wwg, Wwg, Wwg, Ch^Qhh, Wwg, Gg^Qhh, Wo, Gg^Qhh, Gg^Qhh, Gg^Es, Gg, Gg^Efm, Gg^Efm, Gg^Efm, Gs^Qhh, Gg^Qhh, Gg, Gll^Qhu, Gll, Gll, Ss, Gll, Ss, Ss, Wwg, Wwg, Wwg, Ss, Wwg, Ss, Ss, Sm, Ss, Ss, Gll^Edt, Gll^Edt, Ss^Edt
Wo, Wo, Wo, Gg, Wo, Gg, Wo, Wwg, Wo, Wwg, Wwg, Gg^Qhh, Gg^Qhh, Gg^Qhh, Wo, Gg^Qhh, Wo, Gg^Qhh, Wo, Gg^Qhh, Wo, Wo, Wo, Wo, Wo, Wwg, Wwg, Wwf, Wwg, Wwg, Wo, Wo, Wo, Wo, Wo, Gg^Qhh, Gg^Qhh, Gg, Gg^Qhh, Gg^Qhh, Gg, Gg, Gll^Qhu, Gll^Qhu, Ss^Edb, Ss, Ss, Ss, Ss, Ss, Wwg, Ss, Ss, Wwg, Wwg, Ss, Ss, Ss, Ss, Gll, Gll^Edt, Gll^Edt, Ss
Wo, Wo, Wo, Wo, Wo, Wo, Wo, Wo, Wo, Wo, Wo, Wwg, Wo, Wo, Wo, Wo, Wo, Wo, Wo, Wo, Wo, Wo, Wo, Wo, Wwg, Wwg, Wwg, Wwg, Wwg, Wwg, Wo, Wo, Wo, Wo, Wo, Wo, Wo, Gg^Qhh, Gg, Gg, Gg, Gll^Qhu, Gll^Edb, Gll^Edb, Ss^Edb, Ss, Ss, Ss, Ss, Ss, Wwg, Wwg, Wwg, Wwg, Ss, Sm, Sm, Ss, Sm, Gll, Gll, Gll^Edt, Ss
Wo, Wo, Wo, Wo, Wo, Wo, Wo, Wo, Wo, Wo, Ww^Ewf, Wo, Wo, Wo, Wo, Wo, Wo, Wo, Ww^Ewf, Wo, Wo, Wo, Wo, Wo, Wwg, Wwf, Wwf, Wwf, Wwf, Wwg, Wo, Wo, Wo, Wo, Wo, Wo, Wo, Wo, Wo, Wo, Wo, Wo, Wo, Gll^Edb, Sm, Ss, Sm, Ss, Ss, Ss, Ss, Ss, Ss, Ss, Ss, Ss, Ss, Sm, Ss, Sm, Ss^Vhs, Ss, Ss
Wo, Wo, Wo, Ww^Ewf, Wo, Wo, Wo, Wo, Wo, Wo, Wo, Wo, Wo, Wo, Wo, Wo, Ww^Wkf, Wo, Wo, Wo, Wo, Wo, Wo, Wo, Wo, Wwf, Re, Wwf, Re, Wo, Wo, Wo, Wo, Wo, Wo, Wo, Ww^Ewf, Wo, Wo, Wo, Wo, Wo, Ww^Ewf, Wo, Wo, Sm, Sm, Sm, Sm, Ss, Sm, Ss, Sm, Ss, Sm, Ss, Ss, Ss, Ss, Ss, Ss, Ss, Ss
Wo, Wo, Wo, Wo, Wo, Wo, Wo, Wo, Wo, Wo, Wo, Wo, Ww^Wkf, Wo, Ww^Wkf, Ww^Wkf, Ww^Wkf, Ww^Wkf, Ww^Wkf, Wo, Ww^Wkf, Wo, Gg, Wo, Gg, Re, Re, Re, Re, Gg, Gg, Wo, Gg, Wo, Wo, Wo, Wo, Wo, Wo, Wo, Wo, Wo, Wo, Wo, Wo, Wo, Wo, Sm, Sm, Sm, Sm, Sm, Sm, Sm, Sm, Sm, Sm, Sm, Sm, Ss, Sm, Sm, Sm
Ds, Ds^Esd, Wo, Wo, Wo, Wo, Wo, Wo, Ds^Esd, Wo, Ww^Wkf, Ww^Wkf, Ww^Wkf, Ww^Wkf, Ds, Ww^Wkf, Ds, Ww^Wkf, Ds^Esd, Ww^Wkf, Gg, Gg, Gg, Gg, Gg, Re, Re, Re, Re, Gg, Gg, Gg, Gg, Gg, Gg, Wo, Wo, Wo, Wo, Wo, Wo, Wo, Wo, Wo, Wo, Wo, Wo, Wo, Wo, Sm, Wo, Sm, Wo, Sm, Wo, Sm, Sm, Sm, Sm, Sm, Sm, Sm, Wo
Ds, Ds^Esd, Wo, Wo, Wo, Wo, Wo, Wo, Ds^Esd, Ds^Esd, Ds^Esd, Ds^Esd, Ww^Wkf, Ww^Wkf, Ww^Wkf, Ds, Dd^Dc, Ds, Gg^Esd, Gg^Esd, Gg, Gg, Gg^Efm, Gg^Efm, Gg, Gg, Re, Re, Gs^Efm, Gg, Gg, Gg^Es, Gg, Gg, Mm, Hh, Hh, Wo, Ww^Wkf, Ww^Wkf, Ww^Wkf, Ww^Wkf, Wo, Wo, Wo, Wo, Wo, Wo, Wo, Wo, Wo, Wo, Gs^Fds, Wo, Wo, Wo, Sm, Sm, Sm, Sm, Sm, Sm, Wo
Hh, Ds^Esd, Ds, Wo, Wo, Wo, Ds, Ds^Esd, Ds^Esd, Dd^Dc, Ds, Ww^Wkf, Ww^Wkf, Ww^Wkf, Ww^Wkf, Ds, Gg^Esd, Gg^Esd, Gg, Gg, Gg, Gg, Gs^Fds, Gg^Efm, Gs^Efm, Gg, Re, Re, Gs, Gs, Gg, Gg, Mm, Mm, Mm, Hh, Hh, Hh, Ds, Ds, Ds, Ds, Ww, Wo, Wo, Wo, Wo, Ww^Ewf, Wo, Wo, Gd, Gs^Vl, Gd^Ecf, Gs^Fds, Gs^Fds, Wo, Wo, Sm, Wo, Wo, Wo, Wo, Wo
Hh, Hh, Hh, Ds, Ds, Ds, Ww^Wkf, Ww^Wkf, Ds^Esd, Ds^Esd, Ww^Wkf, Ds, Ds, Ww^Wkf, Ds, Ds^Esd, Gg^Esd, Gg^Efm, Gg, Gg, Gs^Efm, Gs^Efm, Gs^Fds, Gs^Fds, Gg, Gs^Efm, Re, Re, Gg, Gg, Hh, Mm, Mm, Mm, Mm, Mm, Hh, Ds, Dd^Dc, Ds, Ds, Ww, Ww, Ww, Ww, Wo, Wo, Wo, Wo, Wo, Wo, Gd, Gd, Gs^Fds, Gs^Fds, Gs^Fds, Gll^Feth, Wo, Wo, Wo, Wo, Wo, Wo
Hh, Hh, Hh, Ds, Hh, Ds, Ds, Ww^Wkf, Ds, Ds^Esd, Ds, Ww^Wkf, Ds, Ds, Ds, Gg^Esd, Gg, Gg^Efm, Gg^Efm, Gs, Gg^Efm, Gg^Efm, Gs^Fds, Gs^Fds, Gs, Gs^Efm, Re, Re, Gg, Gg, Mm, Mm, Mm^Xm, Mm^Xm, Mm, Hh, Hh, Ds^Esd, Ds^Esd, Ds, Ds, Ds, Ds, Ds, Ds, Ww, Ww, Wo, Wo, Wo, Wo, Wo, Wo, Gd, Wo, Gd^Dr, Wo, Wo, Wo, Wo, Wo, Wo, Wo
Hh, Hh, Mm, Hh, Hh, Hh, Hh, Ds, Hh, Ds, Hh, Ds, Hh, Ds, Hh, Hh, Gs, Gg, Gs, Gg^Efm, Gs^Fds, Gs^Fds, Gs^Fds, Gs^Fds, Gg, Gs^Efm, Re, Gg, Gg, Hh, Mm, Mm^Xm, Mm, Mm, Hh, Hh, Gg, Gg, Gg^Esd, Ds^Esd, Ds^Esd, Ds, Ds, Ds, Ds, Ds, Wwg, Ww, Ds, Wo, Wo, Wo, Wo, Wo, Wo, Wo, Wo, Wo, Wo, Wo, Wo, Wo, Wo
Mm, Mm, Mm, Mm, Hh^Vhh, Hh, Hh, Hh, Hh, Hh, Hh, Hh, Hh, Hh, Hh, Gs, Gg, Gs, Gs, Gs^Fds, Gg, Gs^Fds, Gs^Fds, Gs^Fds, Re, Re, Gg^Efm, Re, Re, Hh, Mm, Mm, Mm, Mm, Hh, Gg, Gg, Gg, Gg, Gg, Gg, Gg^Esd, Gg, Ds, Ds, Ds, Wwg, Ds, Ds, Ds, Ds, Ds, Ds, Wo, Ds, Wo, Wo, Wo, Wo, Wo, Wo, Wo, Wo
Mm, Mm, Mm, Mm, Mm, Hh, Hh, Hh, Hh, Hh, Hh, Hh, Hh, Hh, Gs, Gg, Gg, Gg, Re, Gs^Fds, Gg^Efm, Gg, Re, Re, Gg, Gg^Efm, Gg, Gg, Re, Hh, Mm, Mm, Mm, Hh, Hh, Gg, Gg, Gg, Gs, Gg, Gs, Gg, Gg, Gs^Vh, Gs, Gg, Wwg, Ds, Gg^Esd, Ds, Gg^Esd, Ds, Ds^Esd, Ds, Ds, Ds, Ds, Ds, Ds, Ds, Ds, Wo, Ds
Mm, Mm, Mm, Mm, Mm, Hh, Hh, Hh, Hh, Hh, Hh, Hh, Hh, Gs, Gg, Gs, Re, Re, Gg, Re, Re, Re, Gg, Re, Gs, Gs, Gg, Gg, Hh, Re, Re, Mm, Hh, Hh, Re, Gg, Gg, Gs, Gg, Gg, Gs^Fds, Gs^Fds, Gg, Re, Gg, Gs, Wwg, Gg, Gg, Gg^Esd, Gg, Gg, Gg, Gg^Esd, Gg^Esd, Ds^Esd, Gg^Esd, Ds^Esd, Ds^Esd, Ds, Ds^Esd, Ds, Ds^Esd
Mm, Mm, Mm, Mm, Mm, Hh, Hh, Hh, Hh, Hh, Hh, Hh, Hh, Gg, Gg, Gs, Re, Gs, Gg, Gg, Gs, Gg, Gg, Re, Gs, Gs, Gg, Gg, Hh, Mm, Mm, Re, Re, Re, Hh, Re, Re, Gg, Gg, Gg^Es, Gs^Fds, Gs^Fds, Gs^Fds, Re, Gg, Gg^Es, Wwg, Gg, Gg, Gg, Gs^Fds, Gs^Fds, Gg, Gg, Re, Gg, Gg, Gg, Gg, Gg^Esd, Gg, Ds^Esd, Gg
Mm, Mm, Md^Xm, Mm, Mm, Mm, Hh, Hh, Hh, Hh, Hh, Hh, Hh, Gs, Gg, Gs, Hhd^Vhhr, Gs, Hh, Gg, Hh, Gg, Gg, Re, Gg^Wm, Gs, Gg^Eff, Hh, Hh, Mm, Hh, Hh, Hh, Hh, Hh, Hh, Hh, Re, Re, Gs, Gs^Fds, Gs^Fds, Gs, Re, Gg, Gg, Wwg, Gs^Es, Gs, Gs^Fds, Gs^Fds, Gs^Fds, Re, Re, Gg, Re, Gs^Vh, Gs, Gs, Gg, Gg^Es, Gg, Gg
Md^Xm, Md^Xm, Md^Xm, Md^Xm, Mm, Mm, Mm, Hh, Hh, Hh, Hh, Hh, Hh, Hh, Hh, Gg, Hh, Hh, Hh, Hh, Hh, Gs, Re, Re, Gg^Eff, Gg^Eff, Rb^Gvs, Gg^Eff, Hh^Eff, Hh, Hh, Hh, Hh, Hh, Hh, Hh, Hh, Gg, Gg, Re, Re, Gs^Fds, Gg, Re, Gg, Gg, Wwg, Gg, Gg, Gs, Re, Re, Gg^Edb, Gs^Edb, Gs^Edb, Gg^Edb, Gs^Edb, Gs^Edb, Gs, Gg, Gg, Gg, Gg
Md^Xm, Md^Xm, Md^Xm, Md^Xm, Md^Xm, Mm, Mm, Mm, Mm, Hh, Hh, Hh, Hh, Hh, Hh, Hh, Hh, Hh, Hh, Hh, Re, Re, Gg^Eff, Gg^Eff, Rb^Gvs, Rb^Gvs, Rb^Gvs, Rb^Gvs, Hh^Eff, Hh^Eff, Hh, Hh, Mm, Hh, Hh, Hh, Hh, Gg, Gg, Gg, Gg, Re, Re, Re, Re, Gg, Wwg, Gs, Re, Re, Re, Gg, Re^Edb, Gg^Edb, Gg, Gg, Gg, Gg, Gg^Edb, Gs^Edb, Cer^Edb, Cer^Edb, Gg
Md^Xm, Md^Xm, Md^Xm, Md^Xm, Md^Xm, Mm, Mm, Mm, Mm, Mm, Hh, Hh, Hh, Hh, Hh, Hh, Hh, Hh, Hh, Hh, Re, Gs^Eff, Gg^Eff, Rb^Gvs, Rb^Gvs, Rb^Gvs, Hh^Eff, Hh^Eff, Hh, Hh, Hh, Mm, Mm^Xm, Mm, Hh, Hh, Hh, Hh, Hh, Gg, Gg, Gg, Gg, Re, Gs, Re, Wwg^Bw\, Re^Bw/r, Gg, Re, Gs, Re^Edb, Gg, Re, Re, Re, Re, Gg, Gg, Cer^Edb, Cer^Edb, Ker^Edb, Gg
Md^Xm, Md^Xm, Md^Xm, Md^Xm, Mm, Mm, Mm, Mm, Mm, Mm, Hh, Hh, Hh, Hh, Hh, Hh, Hh, Hh, Hh, Hh, Gs, Re, Gs^Vl, Gg^Eff, Gg^Eff, Gg^Eff, Hh, Hh, Hh, Hh, Mm, Mm^Xm, Mm^Xm, Mm^Xm, Hh, Hh, Hh, Hh, Hh, Hh, Hh, Gg, Gg, Gs, Wwg, Wwg, Gs^Fds, Gs^Fds, Gs^Fds, Re, Gg, Gs, Gs^Eff, Gg^Eff, Gg^Eff, Gg, Gg, Re, Re, Gg^Edb, Gg^Edb, Cer^Edb, Gg
Md^Xm, Md^Xm, Md^Xm, Md^Xm, Md^Xm, Md^Xm, Md^Xm, Mm, Mm, Hh^Vhh, Mm, Hh, Hh, Hh, Hh, Hh, Mm, Mm, Mm, Hh, Gg, Gg, Gg, Gg, Gg, Gg, Hh, Hh, Mm, Mm, Mm, Mm, Mm^Xm, Mm, Mm, Hhd^Vhhr, Hh, Hh, Hh, Hh, Hh, Hh, Wwg, Wwg, Gg, Gg, Gg, Gs^Fds, Gg, Re, Gg^Eff, Gg^Eff, Rb^Gvs, Rb^Gvs, Rb^Gvs, Gs^Eff, Gs^Eff, Gs, Gg, Re, Re, Gg^Edb, Gg
Md^Xm, Md^Xm, Md^Xm, Md^Xm, Md^Xm, Md^Xm, Md^Xm, Mm, Mm, Mm, Mm, Mm, Mm, Mm, Mm, Mm, Mm, Mm, Mm, Mm, Hh, Gg, Hh, Gg, Hh, Hh, Hh, Hh, Hh, Mm, Mm^Xm, Mm^Xm, Mm^Xm, Mm^Xm, Mm, Mm, Mm, Hh, Hh, Hh, Wwg, Wwg, Hh, Hh, Hh, Gg, Hh, Gg, Re, Re, Gg^Eff, Gg^Eff, Rb^Gvs, Rb^Gvs, Rb^Gvs, Rb^Gvs, Rb^Gvs, Gs^Eff, Gg^Eff, Gs, Re, Gg, Gs
Md^Xm, Md^Xm, Md^Xm, Md^Xm, Md^Xm, Md^Xm, Md^Xm, Mm, Md^Xm, Md^Xm, Md^Xm, Mm, Mm, Mm, Mm, Mm, Mm, Mm, Mm, Mm, Hh, Hh, Hh, Hh, Hh, Hh, Mm, Mm, Hh, Mm^Xm, Mm, Mm^Xm, Mm^Xm, Mm^Xm, Mm^Xm, Mm^Xm, Mm^Xm, Mm, Mm, Wwg, Mm, Hh, Hh, Hh, Hh, Hh, Hh, Hh^Vhh, Gg, Gg, Gs^Eff, Gs^Eff, Rb^Gvs, Rb^Gvs, Rb^Gvs, Rb^Gvs, Rb^Gvs, Rb^Gvs, Rb^Gvs, Gg^Eff, Gs^Eff, Re, Re
Md^Xm, Md^Xm, Md^Xm, Md^Xm, Md^Xm, Md^Xm, Md^Xm, Md^Xm, Md^Xm, Md^Xm, Md^Xm, Md^Xm, Mm, Mm, Mm, Mm, Mm, Mm, Mm, Mm, Hh, Hh, Hh, Hh, Hh, Hh, Mm, Mm, Mm, Mm, Mm, Mm^Xm, Hh, Mm^Xm, Mm^Xm, Mm^Xm, Hh, Mm, Mm, Wwg, Gg, Hh, Hh, Hh, Hh, Hh, Gg, Hh, Hh, Gg, Gg, Gs^Eff, Rb^Eff, Rb^Gvs, Rb^Gvs, Rb^Gvs, Rb^Gvs, Rb^Gvs, Rb^Gvs, Rb^Gvs, Rb^Gvs, Re^Eff, Gs^Eff
