Gll^Fp, Gll^Fp, Gll^Fp, Gll^Fp, Gll^Fp, Gll^Fp, Gll^Fp, Gll^Fp, Gll^Fp, Gll^Fp, Gll^Fp, Gll^Fp, Gll^Fp, Gll^Fp, Gll^Fp, Gll^Fp, Gll^Fp, Gll^Fp, Gll^Fp, Gll^Fp, Gll^Fp, Gll^Fp, Gll^Fp, Gll^Fp, Gll^Fp, Gll^Fp, Gll^Fdw, Gll^Fp, Gll^Fp, Re^Edb, Gll^Fp, Gll^Fp, Gll^Fp, Gll^Fp, Gll^Fp, Gll^Fp, Gll^Fp, Gll^Fp, Gll^Fp, Gll^Fp, Gll^Fdw, Gll^Fp, Gll^Fp, Re^Edb, Re^Edb, Gll^Fp, Gll^Fp, Gll^Fp, Gll^Fp, Gll^Fp, Wwg, Gll^Fp, Gll^Fp, Gll^Fp, Gll^Fp, Gll^Fp, Gll^Fp, Gll^Fp, Gll^Fp, Gll^Fp, Gll^Fp, Gll^Fp
Gll^Fp, Gll^Fp, Gll^Fp, Gll^Fp, Gll^Fp, Gll^Fp, Gll^Fmf, Gll^Fp, Gll^Fp, Gll^Fp, Gll^Fp, Gll^Fp, Gll^Fdf, Gll^Fp, Gll^Fp, Gll^Fp, Gll^Fmf, Gll^Fp, Gll^Fp, Gll^Fp, Gll^Fp, Gll^Fp, Gll^Fp, Gll^Fp, Gll^Fdw, Gll^Fdw, Gll^Fdw, Gll^Fp, Gll^Fp, Re^Edb, Re^Edb, Gll^Fmf, Gll^Fmf, Gll^Fp, Gll^Fp, Gll^Fp, Gll^Fp, Gll^Fp, Gll^Fdw, Gll^Fp, Gll^Fp, Gll^Fp, Re^Edb, Re^Edb, Gll^Fp, Gll^Fp, Gll^Fp, Gs^Vl, Gll^Fp, Gll^Fp, Gll^Fp, Wwg, Wwg, Gll^Fp, Gll^Fp, Gll^Fp, Gll^Fp, Gll^Fp, Gll^Fp, Gll^Fp, Gll^Fp, Gll^Fp
Gll^Fp, Gll^Fp, Gll^Fp, Gll^Fp, Gll^Fp, Gd^Fdf, Gll^Fmf, Gll^Fmf, Gd^Fdf, Gd^Fdf, Gll^Fdw, Gll^Fdw, Gll^Fp, Gll^Fdf, Gll^Fp, Gll^Fmf, Gll^Fp, Gll^Fmf, Gll^Fmf, Gll^Fmf, Gll^Fp, Gll^Fp, Gll^Fdw, Gll^Fdw, Gll^Fdw, Gll^Fp, Gd^Fmf, Gll^Fdw, Gll^Fdw, Gll^Fp, Gll^Fp, Re^Edb, Gll^Fp, Gll^Fmf, Gll^Fp, Gd^Fmf, Gd^Fmf, Gll^Fdw, Gll^Fdw, Gll^Fp, Re^Edb, Re^Edb, Gll^Fp, Gll^Fp, Gll^Fmf, Gll^Fdw, Gll^Fmf, Gll^Fp, Gll^Fp, Gll^Fdw, Gll^Fdw, Gll^Fp, Gll^Fp, Wwg, Gll^Fmf, Gll^Fp, Gll^Fmf, Gll^Fp, Gll^Feth, Gll^Fp, Gll^Fp, Gll^Fp
Gll^Fp, Gll^Fp, Gll^Fmf, Gll^Fp, Gll^Fmf, Gd^Fdf, Gd^Fdf, Gd^Fdf, Gd^Fdf, Gd^Fdf, Gll^Fp, Gll^Fp, Gll^Fmf, Gll^Fdf, Gll^Fdf, Gll^Fp, Gll^Fmf, Gll^Fp, Gll^Fmf, Gll^Fmf, Gll^Fdw, Gll^Fdw, Gll^Fdw, Gll^Fdw, Gll^Fp, Gd^Fmf, Gll^Fp, Gll^Fp, Gll^Fp, Gll^Fmf, Gll^Fp, Re^Edb, Re^Edb, Gll^Fp, Cer^Edb, Cer^Edb, Cer^Edb, Gll^Fdw, Gd^Fp, Gll^Fdw, Re^Edb, Re^Edb, Gll^Fdw, Gll^Fdw, Gll^Fdw, Gll^Fdw, Gll^Fdw, Gll^Fmf, Gll^Fmf, Gll^Fp, Gll^Fdw, Gll^Fdw, Gll^Fp, Wwg, Wwg, Gll^Fp, Gll^Fp, Gll^Fmf, Gll^Fp, Gll^Fp, Gll^Fp, Gll^Fp
Gll^Fp, Gll^Fp, Gll^Fp, Gll^Fmf, Gd^Fdw, Gd^Fdw, Gd^Fdw, Gd^Fdf, Gll^Fp, Gll^Fp, Gll^Fp, Gll^Fmf, Gll^Fmf, Gll^Fp, Gll^Fp, Gll^Fp, Gll^Fmf, Gll^Fmf, Gd^Fp, Gd^Fp, Gll^Feth, Gll^Fmf, Gd^Fp, Gd^Fmf, Gd^Fmf, Gd^Fmf, Gd^Qhux, Gd^Qhux, Gll^Fmf, Gll^Fmf, Gll^Fmf, Gll^Fp, Re^Edb, Ker^Edb, Cer^Edb, Cer^Edb, Cer^Edb, Gd^Fp, Gd^Fp, Gll^Fdw, Gll^Fp, Re^Edb, Re^Edb, Gll^Fp, Gll^Fp, Gll^Fp, Gll^Fp, Gll^Fdw, Gll^Fp, Gll^Fmf, Gll^Fp, Gll^Fdw, Gll^Fp, Gll^Fp, Gll^Fdw, Wwg, Wwg, Gll^Fp, Gll^Fmf, Gll^Fmf, Ww^Vm, Wwg
Gll^Fp, Gll^Fp, Gd^Fdw, Gd^Fdw, Gll^Fmf, Gll^Fmf, Gd^Fdw, Gd^Fdf, Gll^Fp, Gll^Fp, Gd, Gll^Fp, Gll^Fp, Gll^Fp, Gll, Gll^Fp, Gll^Fmf, Gd^Fp, Gll^Fmf, Gd^Fp, Gd^Fp, Gd^Fp, Gd^Fp, Gd^Fmf, Gd^Fmf, Gd^Fmf, Gd^Qhux, Gd^Qhux, Gll^Fmf, Gll^Fmf, Gll^Fmf, Gll^Fmf, Re^Edb, Gll^Edb, Gll^Fp, Cer^Edb, Gd^Edb, Gd^Fp, Gd^Fp, Gll^Edb, Gll^Edb, Gll^Fp, Re^Edb, Gll^Fp, Gll^Fp, Gll^Fp, Gll^Fp, Gll^Fp, Gll^Fp, Gll^Fp, Gll^Fp, Gll^Fp, Gll^Fp, Gll^Fp, Gll^Fp, Gll^Fdw, Wwg, Gll^Fdw, Wwg, Wwg, Gll^Fdw, Gll^Fp
Gll^Fp, Gll^Fp, Cer^Edb, Ker^Edb, Cer^Edb, Cer^Edb, Gll^Fmf, Gll^Fp, Gll, Gll, Gll^Edb, Gd, Gd, Gll, Gll^Edb, Gll^Fp, Gll^Fmf, Gll^Fmf, Gd^Fp, Gd^Fp, Gd^Qhux, Gd^Qhux, Gd^Qhux, Gd^Qhux, Gd^Qhux, Gd^Qhux, Gll, Gd^Qhux, Gll^Fmf, Gll^Edb, Gll^Edb, Gll^Fmf, Re^Edb, Gll^Edb, Gll^Fp, Gd^Fmf, Gd^Fmf, Gd^Fp, Gd^Fp, Gll^Edb, Gll^Edb, Gll^Edb, Re^Edb, Gll, Gll, Gll, Gll, Gll^Fp, Gll, Gll, Gll, Gll, Gll, Gll^Fp, Gll^Fp, Gll^Fp, Wwg, Wwg, Gll^Fmf, Gll^Fdw, Gll^Fp, Gll^Fp
Gll^Fp, Cer^Edb, Cer^Edb, Cer^Edb, Cer^Edb, Cer^Edb, Gll^Fmf, Gll, Gll^Edb, Gll, Gll^Edb, Gd^Edb, Gd^Vhr, Gll^Edb, Gll^Edb, Gll, Gll, Gd^Fp, Gll, Gll, Gll, Gd^Qhux, Gll, Gll, Gll, Gd^Qhux, Gll, Gll, Gll^Fmf, Gll^Edb, Gll^Edb, Gll^Edb, Re^Edb, Gll^Edb, Gll^Edb, Gd^Fmf, Gd^Fmf, Gd^Fmf, Gll^Edb, Gll^Edb, Gll, Re^Edb, Gll, Gll, Gll^Qhux, Gll, Gll^Qhux, Gll^Qhux, Gll^Qhux, Gll, Gll, Gd, Gll^Edt, Gll, Gll, Gll^Fp, Sm, Gll^Fmf, Gll^Fmf, Gll^Fp, Gll^Fp, Gll^Fp
Re, Gll^Fp, Re, Cer^Edb, Gll^Edb, Cer^Edb, Gll, Gll, Gd^Edb, Gll^Edb, Gll^Edb, Gd^Edb, Gd^Edb, Gd^Edb, Gd^Edb, Gll, Gll, Gll, Gll, Gll^Edb, Gll^Edb, Gll^Edb, Gll^Edb, Gll, Gll^Edb, Gll, Gll^Edb, Gll, Gll^Edt, Gll^Vhr, Re, Re^Edb, Gll, Gll^Edb, Gll^Edb, Gll^Edb, Gll^Edb, Gll^Edb, Gll^Edb, Gll^Edb, Re, Re, Gll^Qhux, Gll^Qhux, Gll, Gll^Qhux, Gll, Gll^Qhux, Gll^Qhux, Gll, Gll^Edt, Gll^Vhr, Gll^Edt, Gll^Edt, Gll, Sm, Gll, Gll^Fp, Gll^Fp, Gll^Fmf, Gll^Fmf, Gll^Fp
Gd^Qhhf, Re, Gd^Qhhf, Re, Re, Gll^Edb, Re, Gll^Edb, Re, Gll^Edb, Re, Gll^Edb, Gll, Gll, Gll, Gll^Edb, Gll, Gll, Gll, Gll^Edb, Gll, Gll, Gll, Gll^Edb, Gll^Edb, Gll^Edb, Gll, Gll^Edb, Gll, Re^Edt, Gll^Edt, Re^Edt, Gd^Edt, Gll, Gll^Edb, Gll^Edb, Gll, Gll^Edb, Re, Re, Gll, Gll, Gll, Gll^Qhux, Gll^Qhux, Gll^Qhux, Gll^Qhux, Gll^Qhux, Gll^Qhux, Gll^Qhux, Gll, Gd^Edt, Gll^Edt, Gll, Sm, Sm, Gll, Gll, Gll, Gll^Fp, Gll^Fp, Gll^Fmf
Gll^Fmf, Gd^Qhhf, Gll^Fmf, Gd^Qhhf, Gd^Qhhf, Re, Gll, Re, Gll, Re, Gll, Re, Re, Gll, Re^Edb, Gll^Edb, Re^Edt, Gll^Edt, Gll, Gd, Gd, Gll, Gd, Gll, Gll^Edb, Gll^Edb, Gll^Edb, Gll, Re^Edt, Re^Edt, Gd^Edt, Gd^Edt, Gll^Edt, Gll, Gll, Gll^Edb, Re, Re, Gll, Gll, Gd, Gll, Gll, Gll, Gll, Gll^Qhux, Gll, Gll^Qhux, Gll, Gll, Gll, Gll^Edt, Ss^Edt, Ss, Hhd, Gll, Gll, Gll, Gd, Gll, Gll, Gll
Gd, Gll^Fmf, Gd^Fetd, Gll^Fmf, Gll^Fmf, Gd^Qhhf, Gd^Qhhf, Gll^Fmf, Gll^Fmf, Gll^Fmf, Gll^Fmf, Gll, Gll, Re, Gll, Re^Edt, Gd^Vhr, Re^Edt, Re^Edt, Gll, Gll, Gd, Gll, Gll, Gll, Gll, Gll, Gll, Re, Gll^Edt, Gll^Edt, Gll^Edt, Re, Re, Re, Re, Re, Re, Gd, Gd, Gll^Edt, Gll, Gll, Gll, Gll, Gll, Gll, Gll, Gll, Gll, Gll, Ss^Edt, Ss^Edt, Hhd, Hhd, Gll^Fmf, Gd, Gll, Gll, Gll, Gll, Gll
Gll^Fmf, Gll^Fmf, Gll^Fmf, Gll^Fmf, Gll^Qhhf, Gll^Qhux, Gll^Qhux, Gd^Qhhf, Gll^Qhux, Gll^Fmf, Gll^Fmf, Gd, Gd, Gll, Gd, Gd^Edt, Gd^Edt, Gll^Edt, Gll^Edt, Re, Re, Gll, Re, Gll, Gll, Gll, Gll, Gll, Re, Re, Re, Re, Gll, Gll, Ss, Gll, Gll, Gll, Gll^Edt, Gd^Edt, Gd^Edt, Gd^Edt, Ss^Edt, Ss, Ss, Ss, Wwf, Wwf, Wwf, Wwf, Wwg, Ss^Edt, Gll^Fmf, Hhd, Gll^Fmf, Gll^Fmf, Gd, Gd, Gd, Gd, Gll, Gll
Gg, Gll^Fmf, Gll^Qhhf, Gll^Qhhf, Gll^Qhux, Gll^Fdf, Gll^Qhux, Gll^Qhux, Gll^Qhux, Gll^Fdf, Gll^Fmf, Gll^Fmf, Gll, Gd, Gll, Gd, Gll, Gll^Edb, Gll, Gll, Gll^Edb, Re^Edb, Gll^Edb, Re^Edb, Re^Edb, Gll, Re, Gll, Re, Gll, Ss, Gll, Ss, Ss, Gll^Edt, Ss, Ss, Gll, Gll^Edt, Gll^Edt, Ss^Edt, Ss^Edt, Ss^Edt, Ss^Edt, Gll, Gll, Sm, Sm, Gll^Edb, Gll, Gll, Gll^Fmf, Gll^Fmf, Hhd, Gd, Gd, Gll, Gll, Gll^Qhh, Gll, Gll, Gll
Wwg, Gll^Fdf, Gll^Fdf, Gll^Qhhf, Gll^Qhhf, Gll^Qhux, Gll^Qhux, Gll^Qhux, Gll^Fmf, Gll^Fmf, Gll, Gll, Gll, Gll, Ss, Gll, Gll, Gll, Ss, Gll, Gll^Edb, Gll, Gll, Gll^Edb, Gll^Edb, Re^Edb, Gll, Re, Wwg^Bw\, Ss, Gll^Edt, Ss, Gll^Edt, Gll^Edt, Gll^Edt, Gll^Edt, Wwf, Wwf, Wwf, Wwg^Edt, Gll^Edt, Ss^Edt, Gll^Edt, Gll, Gd^Fetd, Gll, Sm, Sm^Edb, Gll^Edb, Gll^Edb, Gll, Gll^Fmf, Gll^Fmf, Gd, Gll, Gll, Gll, Gll^Qhh, Hhd^Qhh, Gll^Qhh, Gll^Qhh, Gll^Qhh
Gll, Wwg, Wwg, Gll, Gll, Gll^Fdf, Gll^Fdf, Gll^Qhux, Gll, Gll^Fdf, Gll, Gll, Ss, Ss, Gll^Edb, Ss, Ss, Ss, Ss, Wwf, Wwf, Gll^Edb, Ss^Vhs, Gll^Edb, Gll, Gll^Edb, Ss^Edb, Ss, Gll^Edt, Re^Edt, Re^Edt, Gll^Edt, Gll^Edt, Gll^Edt, Ss, Ss, Gll, Sm, Sm, Gll^Edt, Gll^Edt, Gll^Edt, Gd, Gd, Gd^Edb, Sm, Sm, Sm^Edb, Sm^Edb, Sm^Edb, Sm, Gll, Gll, Gll, Gll, Gll, Gll, Gll^Qhh, Hhd^Qhh, Gll^Qhh, Hhd^Qhh, Hhd^Qhh
Gll, Gll, Gll, Wwg, Wwg, Gll, Gll^Edt, Gll^Edt, Gll^Edt, Gll, Ss, Ss, Gll^Edb, Gll^Edb, Gll^Vhr, Gll^Edb, Ss^Edb, Ss, Ss, Ss, Ss, Wwf, Ss, Ss, Ss, Ss, Ss, Ss, Ss, Ss, Wwg^Bw|, Ss, Ss, Wwf, Sm, Ss, Gll, Sm, Sm, Sm, Sm, Sm^Edt, Sm, Gd^Edb, Gd^Edb, Gll^Edb, Sm^Edb, Sm^Edb, Cer^Edb, Cer^Qhh, Cer^Qhh, Gll, Gd, Gd, Gll, Gll, Gll^Qhh, Gll^Qhh, Hhd^Qhh, Hhd^Qhh, Md, Hhd
Gll, Gll, Gll, Gll, Wwg, Gll^Edt, Gd^Edt, Gll^Edt, Gll^Edt, Gll, Ss, Ss, Gll, Gll^Edb, Wwg^Bw|r, Gll, Ss, Ss, Ss, Wwf, Ss, Ss, Wwf, Ss, Gll^Qhh, Gll^Qhh, Gll^Qhh, Gll^Qhh, Gll^Qhh, Gll^Qhh, Re^Qhh, Gll^Qhh, Gll^Qhh, Gll^Qhh, Sm, Gll, Gll, Md, Md, Md, Md, Sm, Sm^Edb, Sm^Edb, Sm^Edb, Sm^Edb, Cer^Edb, Cer^Edb, Rb, Rb, Rb, Gll, Gll, Gll, Gll, Gll, Gll^Qhh, Hhd^Qhh, Hhd, Md, Md, Md
Gll, Gll, Gll, Gll, Sm, Gll, Gll, Gll^Edt, Gll, Gll, Ss, Ss, Ss, Ss, Gll, Ss, Ss, Ss, Wwf, Wwf, Sm, Wwf, Sm, Gll^Qhh, Sm, Sm, Sm, Sm, Gll^Qhh, Gll^Edb, Gll^Edb, Re^Edb, Gll^Qhh, Sm, Sm, Sm, Sm, Gll, Sm, Md, Sm, Sm, Gll^Edt, Sm, Cer^Qhh, Cer^Qhh, Rb, Rb, Rb^Edt, Rb, Gll, Gll, Gll^Edb, Gd^Edb, Gll, Gll^Qhh, Hhd^Qhh, Hhd^Qhh, Hhd^Qhh, Md, Md, Md
Gll, Gll, Gll, Gll, Sm, Gll, Gll, Gd^Edt, Wwg^Bw\, Ss, Gll, Gll, Gll, Gll, Gll, Gll, Gll, Gll^Qhh, Gll^Qhh, Sm, Sm, Sm, Sm, Sm, Sm, Sm, Cer^Qhh, Cer^Qhh, Cer^Qhh, Gll^Edb, Gll^Edb, Re^Edb, Gll^Qhh, Cer^Qhh, Cer^Qhh, Sm, Cer^Qhh, Sm, Sm, Sm, Gll^Edt, Gd^Edt, Gd^Edt, Gll, Rb, Rb, Rb^Edt, Rb, Gd^Vhr, Gll^Edt, Gll^Edt, Gll^Edb, Gg^Vwm, Gll^Edb, Gll^Edb, Gll^Qhh, Gll^Qhh, Gll^Qhh, Gll^Qhh, Hhd^Qhh, Hhd^_mh, Md
Gll, Gll, Gd, Gd, Gll, Sm, Sm, Sm, Gll, Gll, Gll^Edb, Gll^Edb, Gll^Edb, Gll, Gll, Gll, Gll^Edt, Gll^Qhh, Gll^Edt, Gll^Qhh, Sm, Sm, Cer^Qhh, Cer^Qhh, Cer^Qhh, Cer^Qhh, Rb^Edt, Rb, Rb, Gll, Gll^Edb, Re^Edb, Gll^Qhh, Rb, Rb, Rb, Rb, Cer^Qhh, Rb, Cer^Qhh, Gll, Gll^Edt, Rb^Edt, Gll^Edt, Rb, Rb, Gll, Gll^Edt, Gll^Edt, Gll^Edt, Gd^Edt, Gll^Edb, Gll^Edb, Gll^Edb, Gll^Edb, Gll, Gll^Qhh, Gll^Qhh, Gll^Qhh, Hhd^Qhh, Hhd, Hhd
Gll, Gll, Gd^Vhr, Gll, Gd, Gll, Sm, Sm, Gll, Gll, Gd^Edb, Gd^Edb, Gll^Edb, Gll, Gll, Gll^Edt, Gll^Edt, Gll^Qhh, Gll^Edt, Gll^Qhh, Cer^Qhh, Cer^Qhh, Rb, Rb^Edb, Rb, Rb^Edt, Rb^Edt, Rb^Edt, Rb, Gll, Gll^Edb, Re^Edb, Gll, Gll^Qhh, Rb^Qhh, Rb, Gll, Rb, Rb, Rb, Rb, Rb, Gd, Rb, Gd, Gll, Gll, Gll^Edt, Gll^Edt, Gd^Edt, Gll, Gll, Gd, Gll^Edb, Gll, Gll, Gll^Qhh, Gll^Qhh, Hhd^Qhh, Hhd^Qhh, Hhd, Hhd
Gll, Gd, Gd, Gd, Gd, Gll, Wwg, Gll, Gll, Gll^Edb, Gd^Edb, Gd^Vhr, Gd^Edb, Gll, Gd, Gll^Edt, Gll^Edt, Gll^Qhh, Gll^Qhh, Gll, Gll, Rb, Gll, Gll^_mh, Gll^Edb, Gll^Edt, Gll^Edt, Rb, Gll^Edb, Rb^Edb, Rb^Edb, Rb^Edb, Rb^Edb, Rb, Gll^Edb, Rb^Qhh, Gll^Qhh, Gll, Gll, Gll, Gll, Gll, Gll, Gd, Gll, Gll, Gd, Gd, Gd, Gd, Gll, Gd, Gll, Gll, Gll^Qhh, Gll^Qhh, Hhd^Qhh, Gll^Qhh, Hhd^Qhh, Hhd, Hhd, Hhd
Gll, Gd, Gd, Gd, Wwg, Wwg^Bw\, Gll, Gll, Gll, Gll, Gd, Gd^Edb, Gd, Gd, Gll, Gll^Edt, Gd, Gll, Gll^Qhh, Gll, Gll, Gll, Gd, Gll^Edb, Gll^Edb, Gll, Gll, Gll, Sm^Edb, Gll^Edb, Cer^Edb, Rb^Edb, Cer^Edb, Gll^Edb, Sm^Edb, Gll, Gll, Gll^Qhh, Gll^Qhh, Gll^Qhh, Gll^Qhh, Gll^Qhh, Gll^Qhh, Gll, Gll^Fmf, Gll, Gll, Gd, Gll, Gd, Gll, Gd, Gll, Gll, Gll^Qhh, Gll^Qhh, Gll^Qhh, Hhd^Qhh, Hhd^Qhh, Hhd, Hhd, Hhd
Gll, Gd, Gll, Gll, Wwg, Gll, Gll, Gll, Gll, Gd, Gll, Gll, Hhd, Md, Md, Gd, Gll, Gll, Gll, Gll^Qhh, Gll, Gd, Gd^Edb, Gd^Edb, Gll^Edb, Gll, Sm, Sm, Cer, Cer^Edb, Rb^Edb, Rb^Edb, Rb^Edb, Cer^Edb, Cer^Edb, Sm^Edb, Sm^Edb, Gll, Gll, Gll^Edb, Gll^Edb, Gll, Gll^Qhh, Gll^Fmf, Gd^Fp, Gd^Fp, Gll, Gll, Gll, Gll, Gll, Gll, Gll^Qhh, Gll^Qhh, Gd^Qhh, Gd^Qhh, Gll^Qhh, Gll^Qhh, Hhd^Qhh, Hhd, Hhd, Hhd
Gll, Gll, Gll, Gll, Wwg, Gll, Gll, Gll, Gll, Gll, Gll^Eff, Gll, Hhd, Md, Md, Md, Gll, Gll, Gll, Gll^Qhh, Gll^Qhh, Gd, Gd^Edb, Gd^Edb, Gll^Edb, Sm, Cer, Cer, Rb, Rb^Edb, Rb^Edb, Rb^Edb, Rb^Edb, Rb^Edb, Rb, Cer^Edb, Cer^Edb, Sm^Edb, Gll^Edb, Gd^Edb, Gll^Edb, Gll^Edb, Gll^Qhh, Gll^Fmf, Gd^Fp, Gll^Fmf, Gll^Fmf, Gll, Gll, Gll, Gll, Gll^Qhh, Gll^Qhh, Gll^Qhh, Gll^Qhh, Gd^Qhh, Hhd^Qhh, Gll^Qhh, Hhd^Qhh, Hhd, Hhd, Hhd
Gll, Gll, Gll, Wwg, Gll, Gll, Gll, Gll, Gll^Eff, Gll^Eff, Rb^Gvs, Gll^Eff, Gll^Eff, Gll, Hhd, Hhd, Gll, Gll^Wm, Gll, Gll, Gll^Qhh, Gd, Gd, Gll^Edb, Gll^Edb, Sm, Cer^Edb, Re^Vct, Rb, Cer^Edb, Cer^Edb, Re^Vct, Cer, Cer, Rb^Edt, Re^Vct, Cer^Edb, Sm^Edb, Gd^Edb, Gll^Edb, Gll, Gll^Qhh, Gll^Fmf, Gll^Fmf, Gd^Fp, Gd^Fetd, Gll^Fmf, Gll, Gll, Gll, Gll^Qhh, Gll^Qhh, Gll^Qhh, Hhd^Qhh, Hhd^Qhh, Hhd^Qhh, Hhd, Hhd^Qhh, Hhd, Hhd^Vhhr, Hhd, Hhd
Gll, Gll, Gll, Wwg, Gll, Gll, Gll^Eff, Gll^Eff, Rb^Gvs, Rb^Gvs, Rb^Gvs, Rb^Gvs, Rb^Gvs, Gll^Eff, Gll^Eff, Gll, Gll, Gll, Gll, Gll, Gll, Gll^Qhh, Gll^Qhh, Gll^Edb, Gll, Sm, Cer^Edb, Rb^Edb, Rb^Edb, Re^Vct, Cer, Ker, Cer, Re^Vct, Rb^Edt, Rb^Edt, Cer^Edb, Sm^Edb, Gll^Edb, Gll^Edb, Gll^Qhh, Gll^Qhh, Gll^Fp, Gll^Fmf, Gll^Fmf, Gll^Fmf, Gll^Fmf, Gll^Fmf, Gll, Gll^Qhh, Gll^Qhh, Gd^Qhh, Gd^Qhh, Hhd^Qhh, Hhd^Qhh, Hhd, Hhd, Hhd, Hhd, Hhd, Hhd, Hhd
Gll, Gll, Gll, Wwg, Gll, Gll^Eff, Gll^Eff, Rb^Gvs, Rb^Gvs, Rb^Gvs, Rb^Gvs, Rb^Gvs, Rb^Edb, Rb^Gvs, Rb^Edb, Gll^Eff, Gll^Eff, Gll, Gll, Gll, Gll^Edt, Gll^Edt, Gll^Qhh, Gll, Gll, Sm^Edb, Cer^Edb, Rb^Edb, Rb^Edb, Re^Vct, Rb^Dr, Rb^Esd, Cer, Re^Vct, Rb^Edt, Rb^Edt, Cer^Edb, Sm^Edb, Gll^Edb, Gll^Qhh, Gll^Fp, Gll^Fp, Gll^Fmf, Gll^Fp, Gll^Fmf, Gll^Fmf, Gd^Fp, Gll, Gll, Gll^Qhh, Hhd^Qhh, Gll^Qhh, Gd^Qhh, Gll^Qhh, Gll^Qhh, Hhd^Qhh, Hhd, Hhd, Md, Md, Md, Hhd
Gll, Gll, Gll, Wwg, Wwg, Gll, Gll, Gll^Eff, Gll^Eff, Rb^Gvs, Rb^Gvs, Rb^Edb, Rb^Edb, Rb^Edb, Rb^Edb, Rb^Gvs, Rb^Gvs, Gll^Eff, Gll^Eff, Gll^Edt, Gll^Edt, Gll^Edt, Gll^Qhh, Gll^Qhh, Gll, Sm, Cer, Re^Vct, Rb, Rb^Dr, Rb, Rb^Edt, Rb^Edt, Cer, Rb, Re^Vct, Cer, Sm^Edb, Gll, Gll^Qhh, Gll^Fp, Gll^Fmf, Gll^Fmf, Gll^Fmf, Gll^Fmf, Gd^Fp, Gll^Fdf, Gll, Gll^Qhh, Gll^Qhh, Hhd^Qhh, Gll^Qhh, Gll^Qhh, Gll^Qhh, Hhd^Qhh, Hhd^Qhh, Md, Md, Md, Md, Md, Md
Gll, Gll, Gll, Gll, Wwg, Gll^Wm, Gll, Gll, Gd, Gll^Eff, Gll^Eff, Rb^Edb, Rb^Edb, Rb^Edb, Rb^Edb, Rb^Edb, Re, Gll^Eff, Gll, Gll, Gd^Edt, Gll^Edt, Gll^Edt, Gll^Qhh, Gll, Sm, Sm, Cer, Cer, Rb, Rb^Edb, Rb^Edt, Rb^Edb, Rb^Edt, Cer^Edb, Cer, Sm, Sm^Edb, Gll, Gll^Qhh, Gll, Gll^Fmf, Gll^Fdf, Gll^Fdf, Gll^Fmf, Gd^Fp, Gll^Fdf, Gll, Gll, Gll^Qhh, Gll^Qhh, Hhd^Qhh, Hhd^Qhh, Hhd^Qhh, Hhd^Qhh, Hhd, Md, Md, Md, Md, Md, Md
Gll, Gll, Gll, Gll, Gll, Wwg, Gll, Gll, Gd, Gd, Gd, Gll^Eff, Gll^Eff, Rb^Gvs, Gd^Eff, Gd^Eff, Gll, Re, Gll, Gd, Gd, Gd^Edt, Gll, Gll^Qhh, Gll^Qhh, Gll, Gll, Sm, Sm, Cer^Edb, Rb^Edb, Rb^Edb, Rb^Edb, Cer^Edb, Sm^Edb, Sm^Edb, Gll^Edb, Gll, Gll, Gll^Qhh, Gll^Qhh, Gll^Fmf, Gll^Fdf, Gd^Fp, Gd^Fp, Gd^Fp, Gll^Fmf, Gll, Gll, Gll^Qhh, Gll^Qhh, Gll^Qhh, Gll^Qhh, Gll^Qhh, Hhd^Qhh, Hhd, Md, Md, Md, Md, Hhd, Hhd
Ds, Ds, Ds, Ds, Ds, Wwg, Ds, Gll, Ds, Gd, Gd, Gll, Gll, Gll, Gll, Gll, Gll^Edt, Re^Edt, Re^Edt, Gd, Gll, Gll, Gll^Vc, Gll, Gll^Qhh, Gll, Gll, Gll, Gll^Edb, Gll^Edb, Rb^Edb, Rb^Edb, Rb^Edb, Gll^Edb, Gll^Edb, Gll^Edb, Gll^Edb, Gll, Gll^Edb, Gd^Vhr, Gll^Qhh, Gll, Gll, Gll^Fdf, Gll, Gd^Fp, Gll, Gll, Gll, Gll^Qhh, Gll^Qhh, Gll^Qhh, Gll^Qhh, Gll^Qhh, Hhd^Qhh, Hhd, Hhd, Md, Hhd, Hhd^Vhhr, Hhd, Hhd
Ww^Wkf, Ww^Wkf, Ww^Wkf, Ww^Wkf, Ds, Wwg, Wwg, Ds, Ds, Ds, Ds, Gll, Ds, Gll, Gll, Gll, Gll^Edt, Gll^Vhr, Re^Edt, Re^Edt, Re, Re, Re, Re, Re^Qhh, Gll, Re, Gll^Edb, Re^Edb, Gll^Edb, Re, Rb^Edb, Rb, Gll, Gll, Gll, Rb, Rb^Edb, Gll^Edb, Gll^Edb, Gll^Qhh, Gll, Gll, Gll, Gll, Gll, Gll, Gll, Gll, Gll^Qhh, Gll^Qhh, Hhd^Qhh, Gll^Qhh, Hhd^Qhh, Hhd, Hhd, Cer^Edb, Hhd, Hhd, Hhd, Hhd, Hhd
Wwg, Ww^Wkf, Ww^Wkf, Ww^Wkf, Wwg, Ds, Wwg, Wwg, Wwg, Wwg, Wwg, Ds, Ds, Ds, Ds, Ds, Ds, Re^Edt, Gll, Gll, Gll, Gll, Gll, Re, Gll^Qhh, Re, Gll, Re, Gll^Edb, Re^Edb, Re^Edb, Re, Rb, Rb, Rb, Rb, Gll, Rb, Gll^Qhh, Gll^Qhh, Gll, Gll, Gd, Gll, Gd, Gll, Gll, Gll, Gll, Gll, Gll^Qhh, Hhd^Qhh, Hhd^Qhh, Hhd^Qhh, Cer^Edb, Cer^Edb, Ker^Edb, Cer^Edb, Cer, Hhd, Hhd, Hhd
Wwg, Wwg, Wwg, Ww^Wkf, Wwg, Wwg, Wwg, Wwg, Ww^Wkf, Ww^Wkf, Ww^Wkf, Ww^Wkf, Ww^Wkf, Ds, Wwg, Ds, Wwg, Ds^Edt, Ds, Ds, Ds, Gll, Gll, Gll, Gll, Gll^Qhh, Gll^Qhh, Gll, Gll, Gll^Edb, Gd^Edb, Gll^Edb, Gll, Rb, Rb, Rb, Rb, Gll, Gll^Qhh, Gll, Gll, Gd, Gd, Gd, Gd^Edb, Gll^Edb, Gll, Gll, Gll, Gll, Gll^Qhh, Gll^Qhh, Hhd^Qhh, Hhd^Edb, Hhd^Edb, Cer^Edb, Cer^Edb, Cer^Edb, Hhd, Hhd, Hhd, Hhd
Wog, Wog, Wog, Wog, Wog, Wog, Wog, Wwg, Wog, Wwg, Ww^Wkf, Wwg, Wwg, Wwg, Wwg, Wwg, Wwg, Ds, Wwg, Wwg, Wwg, Ds, Ds, Gll, Gll, Gll, Gll, Gll^Qhh, Gll^Qhh, Gll, Gd, Gd, Gd^_mh, Gd, Rb, Rb, Rb, Rb, Gll^Qhh, Rb, Gll, Gll, Gll^Edb, Gll^Edb, Gs^Vh, Gll^Edb, Gd, Gll, Gll, Gll, Gll^Qhh, Gll^Qhh, Gll^Qhh, Hhd^Qhh, Hhd^Qhh, Hhd^Edb, Hhd^Edb, Hhd, Hhd, Hhd, Hhd, Hhd
Wog, Wog, Wog, Wog, Wog, Wog, Wog, Wog, Wog, Wog, Wog, Wog, Wog, Wwg, Wog, Wwg, Wwg, Wwg, Wwg, Wwg, Wwg, Wwg, Wwg, Ds, Ds, Gd^Vl, Ds, Gll, Gll, Gll^Qhh, Gd^Qhh, Gll, Gd, Gll, Rb, Gll, Rb, Rb, Rb^Qhh, Rb, Gll, Gll, Gll^Edb, Gll^Edb, Gd^Edb, Gd^Edb, Gll, Gd, Gll, Gll, Gll, Gll^Qhh, Gll^Qhh, Gll^Qhh, Hhd^Qhh, Hhd, Hhd, Hhd^_mh, Hhd, Hhd, Hhd, Hhd
Wog, Wog, Wog, Wog, Wog, Wog, Wog, Wog, Wog, Wog, Wog, Wog, Wog, Wog, Wog, Wog, Wog, Wwg, Wwg, Wwg, Wwg, Ww^Wkf, Ww^Wkf, Ww^Wkf, Ww^Wkf, Ds, Wwg, Ds, Gll, Gll, Gll, Gd^Qhh, Gll^Qhh, Gll, Gll, Gll, Gll^Qhh, Rb^Qhh, Rb, Rb, Gll, Gll, Gd, Gd, Gd, Gll, Gd, Gd, Gll, Gll, Gll^Qhh, Gll^Qhh, Gll^Qhh, Hhd^Qhh, Hhd, Hhd, Hhd, Hhd, Hhd, Hhd, Md, Md
Wog, Wog, Wog, Wog, Wog, Wog, Wog, Wog, Wog, Wog, Wog, Wog, Wog, Wog, Wog, Wog, Wog, Wog, Wog, Wog, Wwg, Wwg, Wwg, Ww^Wkf, Ww^Wkf, Ww^Wkf, Wwg, Ds, Ds, Gll, Gll, Gll, Gll, Gll^Qhh, Gll^Qhh, Gll^Qhh, Gll, Gll, Cer^Edb, Cer, Gll, Gll, Gll, Gd, Gll, Gll, Gll^Qhh, Gll, Gll^Qhh, Gll^Qhh, Gll^Qhh, Gll^Qhh, Hhd^Qhh, Hhd^Qhh, Hhd, Hhd, Hhd, Hhd, Hhd, Md, Md, Md
Wog, Wog, Wog, Wog, Ds^Qhh, Wog, Wog, Wog, Wog, Wog, Wog, Wog, Wog, Wog, Wog, Wog, Wog, Wog, Wog, Wog, Wog, Wwg, Wog, Wwg, Wwg, Wwg, Ww^Wkf, Ds, Ds, Gll, Gll, Gll, Gll, Gll, Gll, Gll, Gll^Edb, Cer^Edb, Cer^Edb, Cer, Rb^Edb, Gll, Gll, Gll, Gll^Qhh, Gll^Qhh, Gll^Qhh, Gll^Qhh, Gll^Qhh, Gll^Qhh, Gll^Qhh, Hhd^Qhh, Hhd, Hhd, Hhd, Hhd, Hhd, Hhd, Md, Md, Md, Md
Wog, Wog, Ds^Qhh, Ds^Qhh, Mv, Ds^Qhh, Wog, Wog, Wog, Wog, Wog, Wog, Wog, Wog, Wog, Wog, Wog, Wog, Wog, Wog, Wog, Wog, Wog, Wog, Wog, Wwg, Wwg, Wwg, Wwg, Ds, Ds, Gll, Gll, Gd, Gll, Gll^Edb, Gll, Cer^Edb, Ker^Edb, Cer^Edb, Rb^Edb, Gll, Gll, Gll, Gll^Qhh, Gll^Qhh, Hhd^Qhh, Gll^Qhh, Hhd^Qhh, Hhd^Qhh, Hhd^Qhh, Hhd^Qhh, Hhd, Hhd, Hhd, Hhd, Md, Md, Md, Md, Md, Md
Wog, Wog, Ds^Qhh, Khs, Mv, Ds^Qhh, Ds^Qhh, Wog, Wog, Wog, Wog, Wog, Wog, Wog, Wog, Wog, Wog, Wog, Wog, Wog, Wog, Wog, Wog, Wog, Wog, Wwg, Wwg, Wwg, Wwg, Wwg, Ds, Gll, Gd, Gd, Gll, Gll, Rb, Rb, Rb, Rb, Gll^Wm, Rb, Gll, Gll, Gll^Qhh, Hhd^Qhh, Hhd, Hhd^Qhh, Hhd, Hhd, Hhd, Hhd, Hhd, Hhd, Hhd, Hhd^Vhhr, Md, Md, Md, Md, Md, Md
Wog, Wog, Wog, Ds^Qhh, Ds^Qhh, Ds^Qhh, Ds^Qhh, Wog, Wog, Wog, Wog, Wog, Wog, Wog, Wog, Wog, Wog, Wog, Wog, Wog, Wog, Wog, Wog, Wog, Wog, Wog, Wog, Wwg, Wwg, Wwg, Wwg, Ds, Gll, Gd, Gll^Edt, Rb^Edt, Gll^Edt, Gd^Vhr, Rb, Rb, Gll, Rb, Gll, Gll, Gll^Qhh, Hhd^Qhh, Hhd, Hhd, Hhd, Hhd, Hhd, Hhd, Md, Hhd, Md, Md, Md, Md, Md, Md, Md, Md
Wog, Wog, Wog, Wog, Wog, Ds^Qhh, Wog, Wog, Wog, Wog, Wog, Wog, Wog, Wog, Wog, Wog, Wog, Wog, Wog, Wog, Wog, Wog, Wog, Wog, Wog, Wog, Wog, Wog, Wwg, Wwg, Ds, Ds, Gll, Gll, Gll^Edt, Gll^Edt, Gll^Edt, Gll^Edt, Rb^Edt, Rb, Gll, Gll, Gll^Qhh, Gll^Qhh, Hhd^Qhh, Hhd^Qhh, Hhd, Hhd, Hhd, Hhd, Md, Md, Md, Md, Md, Md, Md, Md, Md, Md, Md, Md
Wog, Wog, Wog, Wog, Wog, Wog, Wog, Wog, Wog, Wog, Wog, Wog, Wog, Wog, Wog, Wog, Wog, Wog, Wog, Wog, Wog, Wog, Wog, Wog, Wog, Wog, Wog, Wog, Wog, Wwg, Ds, Ds, Gll, Gll, Gll, Gll^Edt, Rb^Edt, Rb^Edt, Rb, Rb, Rb, Gll^Qhh, Gll^Qhh, Hhd^Qhh, Hhd^Qhh, Hhd, Hhd, Hhd, Hhd, Hhd, Md, Md, Md, Md, Md, Md, Md, Md, Md, Md, Md, Md
