Gg^Fds, Gg^Fds, Gg, Re, Gg, Gg^Fds, Gg^Fds, Gg^Fms, Gg^Fms, Gg^Fms, Gg^Fms, Gg^Fms, Gg^Fms, Gg^Fms, Gg^Fms, Gg^Fms, Gd^Fp, Gd^Fp, Gd^Fp, Ww, Ww, Gg^Fp, Gg^Fp, Gs, Gg^Fp, Gg^Fp, Gg^Fp
Gg^Fds, Gg^Fds, Gg, Re, Gs^Vl, Gg^Fds, Gg^Fds, Gg^Fds, Gg^Fds, Gg^Fds, Gg^Fds, Gg^Fms, Gg^Fds, Gg^Fms, Gg^Fms, Gg^Fms, Gd^Fp, Gd^Fp, Gg^Fp, Ww, Ww, Gg^Fp, Gg^Fp, Gg, Gg^Fp, Gg^Fp, Gg^Fp
Gg^Fds, Gg^Fds, Gs^Vl, Rp, Rp, Gg^Fds, Gg^Fds, Gg^Fds, Gg^Fms, Gg^Fds, Gg^Fms, Gg^Fds, Gg^Fms, Gg^Fds, Gg^Fms, Gd^Fp, Gd^Fp, Gd^Fp, Gg^Fp, Gg^Fp, Gg^Fp, Ww, Ww, Gg^Fp, Gg^Fp, Gg^Fp, Gg^Fp
Gg^Fds, Gg^Fds, Gg^Fds, Gg, Gg^Fds, Rp, Rp, Gg^Fds, Gg^Fds, Gg^Fms, Gs^Fds, Gg^Fms, Gs^Fds, Gg^Fms, Gs^Fds, Ss, Gd^Fp, Gd^Fp, Gs^Fds, Gg^Fp, Gg^Fp, Ww, Ww, Gg^Fp, Gg^Fp, Gg^Fp, Gg^Fp
Gg^Fds, Gg^Fds, Gg^Fds, Gg^Fds, Gg^Fms, Gg^Fds, Rp, Gg, Gg^Fms, Gg^Fms, Gs^Fds, Gg^Fms, Gg^Fms, Gg^Fms, Gg^Fms, Gg^Fms, Gs^Fds, Gg^Fms, Gg^Fms, Gg^Fp, Gg^Fp, Gg^Fp, Gg^Fp, Ww, Ww, Gg^Fp, Gg^Fp
Gg^Fds, Gg^Fds, Gg^Fms, Gg^Fms, Gg^Fds, Gg^Fds, Rp, Gg^Fms, Gs^Fds, Gg^Fms, Gg^Fms, Gg^Fms, Gg^Fms, Gg^Fms, Gg^Fms, Ss, Ss, Gs^Fds, Gs^Fds, Gg^Fms, Gg^Fms, Gg^Fp, Gg^Fp, Ww, Ww, Gg^Fp, Gll^Fp
Gg^Fds, Gg^Fds, Gg^Fds, Gg^Fms, Gg^Fds, Gg^Fds, Gg^Fds, Rp, Rp, Gg^Fms, Gg^Fms, Gg^Fms, Gg^Fms, Gg^Fms, Gs^Fds, Ss, Gs^Fds, Gs^Fds, Gg^Fms, Gg^Fms, Gg^Fp, Gg^Fp, Gg^Fp, Gg^Fp, Ww, Gg^Fp, Gg^Fp
Gg^Fds, Gg^Fms, Gg^Fms, Gg^Fms, Gg^Fms, Gg^Fds, Gg^Fds, Rp, Rp, Gg^Fms, Gg^Fms, Gg^Fms, Gg^Fms, Gg^Fms, Gs^Fds, Gs^Fds, Ss, Gg^Fms, Gs^Fds, Gg^Fms, Gg^Fms, Gg^Fp, Gg^Fp, Gg^Fp, Gg^Fp, Ww, Gg
Gg^Fds, Gg^Fds, Gg^Fms, Gd^Fp, Gd^Fp, Gg^Fms, Gg, Gg^Fms, Rp, Gg^Fms, Gg^Fms, Gg^Fms, Gg^Fms, Gg^Fms, Gd^Fp, Ss, Ss, Gg^Fp, Gg^Fp, Gg^Fms, Gg^Fms, Gg^Fp, Gg^Fp, Gg^Fp, Gll^Fp, Ww, Ww
Gg^Fds, Gg^Fds, Gg^Fms, Gd^Fp, Gd^Fp, Gg^Fms, Gg^Fms, Gs^Fds, Gs^Fds, Rp, Gs^Fds, Gg^Fms, Gg^Fms, Gg^Fms, Ss, Ss, Ss, Ss^Vhs, Gs^Fds, Gs^Fds, Gg^Fp, Gg^Fp, Gg, Gll^Fp, Gg^Fp, Ww, Ww
Gg^Fds, Gg^Fds, Gd^Fp, Gd^Fp, Gg^Fms, Gg^Fms, Gg^Fms, Gs^Fds, Gg^Fp, Rp, Rp, Gs^Fds, Gg^Fms, Gs^Fds, Gs^Fds, Gd^Fp, Gs^Fds, Ss, Gs^Fms, Gg^Fp, Gg, Gg^Fp, Gg^Fp, Gg^Fp, Gg^Fp, Gg^Fp, Ww
Gg^Fms, Gg^Fms, Gs^Fds, Gd^Fp, Gg^Fms, Gd^Fp, Gg, Gg^Fms, Gg^Fp, Gg^Fp, Gg^Fp, Rp, Rp, Gg^Fms, Rp, Gs^Fds, Gd^Fp, Gs^Fms, Gg, Gg^Fp, Gg^Fp, Gg^Fp, Gg^Fp, Gg^Fp, Gg^Fp, Gg^Fp, Ww
Gd^Fp, Gg^Fms, Gg^Fms, Gg^Fms, Gg^Fms, Gg^Fms, Gg, Gs^Fms, Gg^Fp, Gg^Fp, Gg^Fp, Gg^Fp, Gg^Fp, Rp, Gs^Fms, Rp, Gg, Gg, Gg^Fp, Gg^Fp, Gg^Fp, Gg^Fp, Gg^Fp, Gg^Fp, Gg^Fp, Ww, Ww
Gs^Fms, Gd^Fp, Gd^Fp, Gg, Gg, Gg, Gg^Fp, Gg^Fp, Gg^Fp, Gg^Fp, Gg^Fp, Gs^Fms, Gs^Fds, Gs^Fms, Gs^Fet, Rp, Gg^Fp, Gg^Fp, Gs^Fet, Gg^Fp, Gg^Fp, Gg^Fp, Gg^Fp, Gg^Fp, Ww, Ww, Gg^Fp
Gs^Fms, Gs^Fms, Gs^Fms, Gd^Fp, Gs^Fms, Gs^Fms, Gg^Fp, Gg^Fp, Gg^Fp, Gg^Fp, Gs^Fms, Gs^Fms, Gs^Fet, Gs^Fms, Ss, Rp, Rp, Ss, Ss, Gg^Fp, Gg^Fp, Gg^Fp, Gg^Fp, Gg^Fp, Ww, Gg^Fp, Gg^Fp
Gs^Fms, Gs^Fms, Gg^Fp, Gs^Fms, Gs^Fms, Gg^Fp, Gg^Fp, Gg^Fp, Gs^Fms, Gs^Fms, Gs^Fms, Gs^Fds, Gs^Fds, Ss, Ss, Gs^Fet, Rp, Gs^Fet, Ss, Gs^Fet, Gg^Fp, Gg^Fp, Gg^Fp, Gg^Fp, Ww, Gg^Fp, Gd^Fp
Gg^Fp, Gg^Fp, Gs^Fms, Gg^Fp, Gs^Fms, Gg^Fp, Gg^Fp, Gg^Fp, Gs^Fms, Gs^Fds, Gs^Fds, Gs^Fds, Gs^Fet, Ss, Ss, Ch, Kh, Ch, Ss, Ss, Gs^Fet, Gg^Fp, Gg^Fp, Gg^Fp, Ww, Gg^Fp, Gg^Fp
Gg^Fp, Gg^Fp, Gg^Fp, Gs^Fms, Gs^Fms, Gg^Fp, Gg^Fp, Gg^Fp, Gs^Fms, Gs^Fds, Gs^Fms, Gs^Fds, Gs^Fds, Gs^Fds, Ss, Ch, Gs^Fet, Ch, Rp, Ss, Gs^Fds, Gg^Fp, Gs^Fms, Gg^Fp, Ww, Gg^Fp, Gg^Fp
Ww, Ww, Ww, Gg, Gg^Fp, Gg^Fp, Ww, Gg^Fp, Ww, Gs^Fms, Gs^Fms, Gs^Fds, Gs^Fds, Gs^Fet, Ss, Ss, Ss, Ss, Rp, Gs^Fet, Gs^Fds, Gs^Fms, Gg^Fp, Gg^Fp, Ww, Gg^Fp, Gs^Fp
Gs^Fp, Gs^Fp, Gd^Fp, Ww, Ww, Ww, Ww, Ww, Gg^Fp, Ww, Ww, Gs^Fds, Ss, Ss, Gs^Fet, Ss, Gg^Fds, Gs^Fet, Gg^Fds, Rp, Rp, Gs^Fms, Gs^Fms, Gg^Fp, Ww, Ww, Ww
Gs^Fp, Gs^Fp, Gd^Fp, Gg, Gg, Gs^Fp, Gg^Fp, Gs^Fp, Gg^Fp, Gg^Fp, Gg^Fp, Ww, Ww, Ss, Ss, Ss, Gs^Fms, Gg^Fds, Gg^Fds, Gg^Fds, Gg^Fms, Rp, Rp, Gg^Fp, Gg^Fp, Ww, Ww
Gd^Fp, Gd^Fp, Gd^Fp, Gd^Fp, Gg, Gg^Fp, Gll^Fp, Gg^Fp, Gg^Fp, Gg^Fp, Gg^Fp, Gg^Fp, Gg^Fp, Ww, Ss, Gs^Fms, Gg^Fds, Gg^Fds, Gg^Fms, Gg^Fms, Gg^Fp, Gg^Fms, Hh, Rp, Hh^Fp, Gg^Fp, Gg
Gd^Fp, Gd^Fp, Gd^Fp, Gd^Fp, Gd^Fp, Gg, Gll^Fp, Gg^Fp, Gg^Fp, Gg^Fp, Gg^Fp, Gg^Fp, Gg^Fp, Ww, Ww, Gs^Fms, Gs^Fms, Gg^Fds, Gg^Fms, Gg^Fms, Gg^Fp, Hh, Gg, Gg, Hh, Hh^Fp, Gg
Gd^Fp, Gd^Fp, Gs^Fp, Gs^Fp, Gd^Fp, Gd^Fp, Gll^Fp, Gg^Fp, Gg^Fp, Gg^Fp, Gg^Fp, Gg^Fp, Gg^Fp, Gg^Fp, Gg^Fp, Ww, Ww, Ww, Ww, Gg^Fp, Gs^Fms, Gg^Fp, Hh^Fp, Hh, Hh^Fp, Gg^Fp, Gg^Fp
Gd^Fp, Gd^Fp, Gs^Fp, Gs^Fp, Gd^Fp, Gd^Fp, Gg, Gg^Fp, Gg^Fp, Gg^Fp, Gg^Fp, Gg^Fp, Gg^Fp, Gg^Fp, Gg^Fp, Gg^Fp, Gg^Fp, Gg^Fp, Ww, Ww, Ww, Gg^Fp, Ww, Hh^Fp, Gg^Fp, Gg^Fp, Gg
Gd^Fp, Gs^Fp, Gs^Fp, Gs^Fp, Gs^Fp, Gd^Fp, Gd^Fp, Gg, Gg, Gg^Fp, Gs^Fp, Gg^Fp, Gg^Fp, Gg^Fp, Gg^Fp, Gg^Fp, Gg^Fp, Gg^Fp, Gg^Fp, Gs^Fp, Gs^Fp, Ww, Ww, Ww, Ww, Ww, Ww
