Ss^Qhux, Sm^Qhux, Ss^Qhux, Ss^Qhux, Ss^Qhux, Ss^Qhux, Sm^Qhux, Sm^Qhux, Aa, Aa, Aa, Aa^Esa, Aa^Esa, Aa, Aa, Aa, Aa, Aa, Aa, Aa, Aa, Aa, Aa, Aa, Ai^Esa, Ai, Aa, Aa, Aa, Aa, Ai, Ai, Ai, Ss, Aa^Qhh, Aa^Qhh, Aa^Qhh, Aa^Qhh, Aa^Qhh, Aa^Qhh
Ss^Qhux, Sm^Qhux, Sm^Qhux, Ss^Qhux, Sm^Qhux, Sm^Qhux, Aa, Aa, Aa, Aa, Aa, Aa^Esa, Aa^Esa, Aa, Ss, Aa, Aa, Aa, Aa, Ss, Aa, Ss^Qhux, Ai^Esa, Ai^Esa, Aa^Esa, Aa, Aa^Es, Aa^Es, Aa^Es, Aa, Ss, Ai, Sm, Ss, Aa^Qhh, Aa^Esa, Aa^Es, Aa^Fda, Aa^Fda, Aa^Qhh
Ss^Qhux, Ss^Qhux, Sm^Qhux, Aa^Fda, Aa^Fda, Aa, Aa^Esa, Aa, Aa^Esa, Sm, Sm, Aa, Ai^Esa, Aa, Ss, Ss, Ss^Bw/r, Ss^Bw/r, Ss^Bw\r, Ss, Aa, Ss^Qhux, Ai, Ai^Esa, Aa, Aa^Es, Ss^Vhs, Aa, Ss, Ss, Aa, Ai, Sm, Aa, Aa^Qhh, Aa^Fda, Aa^Fda, Aa^Fda, Aa^Fda, Aa^Qhh
Sm^Qhux, Sm^Qhux, Sm^Qhux, Aa^Fda, Aa, Sm^Qhux, Sm^Qhux, Aa^Esa, Aa, Sm, Sm, Ss, Aa^Esa, Aa, Ai^Bw/r, Aa^Bw/r, Aa, Aa, Ss, Aa, Aa, Aa, Ai^Bw/r, Ai^Bw/r, Aa, Ss, Ss, Ss^Bw\r, Aa, Aa, Aa^Esa, Aa^Esa, Sm, Sm, Aa^Qhh, Aa^Fda, Aa^Esa, Aa^Fda, Aa^Esa, Aa^_mhh
Sm^Qhux, Sm^_mll, Sm^Qhux, Sm^Qhux, Aa, Aa^Qhux, Ss^Qhux, Sm^Qhux, Sm^Qhux, Aa, Sm^Bw/r, Ss^Bw\r, Aa, Ss^Vhs, Aa, Ai, Aa, Aa, Aa, Aa, Aa, Aa, Ai^Esa, Ai, Aa, Aa^Esa, Aa^Esa, Ss, Aa, Aa^Esa, Aa^Esa, Aa^Esa, Aa, Sm, Sm, Aa^Qhh, Aa^Qhh, Aa^Esa, Aa^Qhh, Aa^Esa
Aa^Qhux, Ss^Qhux, Sm^Qhux, Aa, Aa, Ss^Qhux, Aa^Es, Aa^Es, Aa^Bw/r, Sm^Bw/r, Aa, Ss, Ss, Ss, Aa, Aa, Ai, Ss^Qhux, Ss^Qhux, Ss^Qhux, Ss^Qhux, Ss^Qhux, Ss^Qhux, Ai, Ss, Aa^Esa, Ss, Ss, Ss, Aa, Ss, Aa, Ss, Sm, Aa^Es, Aa, Aa, Aa^Qhh, Aa^Qhh, Aa^Qhh
Sm^Qhux, Ss^Qhux, Ss^Qhux, Aa, Ss^Vhs, Aa, Ss^Bw/r, Aa^Bw/r, Ss^Qhux, Aa, Ss^Qhux, Aa, Aa, Aa^Es, Aa, Aa^Es, Ai, Ss^Qhux, Ss^Qhux, Ss^Qhux, Aa, Ss^Qhux, Aa, Aa, Sm, Aa, Aa, Ss, Aa, Ss, Aa, Ss, Aa, Ss, Ai, Ai, Ai, Aa, Aa^Fda, Aa^Qhh
Sm^Qhux, Sm^Qhux, Aa^Esa, Aa, Ss, Aa^Bw\r, Aa, Aa, Aa, Ss^Qhux, Ss^Qhux, Aa, Sm^Qhux, Sm^Qhux, Ai, Ai, Ai, Ai, Aa, Ss, Ss, Aa, Aa^Esa, Aa^Esa, Aa, Aa, Ss, Ss, Aa, Aa, Aa^Fda, Aa, Aa^Fda, Ss, Ss, Ss, Ss, Aa^Fda, Aa^Fda, Aa^Qhh
Sm^Qhux, Aa, Aa^Esa, Aa^Esa, Ss, Ss, Ss, Aa, Ss^Qhux, Aa, Ss^Qhux, Sm^Qhux, Ss^Qhux, Aa, Sm^Qhux, Ss^Qhux, Sm^Qhux, Ss^Qhux, Aa, Ss, Ss^Bw/r, Aa, Aa^Esa, Aa, Aa, Sm, Sm, Aa, Ss, Aa, Aa^Fda, Aa^Fda, Aa, Aa, Ss, Ss, Sm, Aa^Fda, Aa, Aa^Qhh
Aa^Qhux, Sm^Qhux, Sm^Qhux, Aa, Aa^Fda, Aa^Fda, Aa^Fda, Aa, Aa, Ss^Qhux, Sm^Qhux, Sm^Qhux, Sm^Qhux, Sm^Qhux, Sm^Qhux, Sm^Qhux, Aa, Aa, Aa, Ss^Bw/r, Ss, Ss, Ss, Aa^Esa, Ss, Ss, Sm, Ss, Aa, Aa, Aa^Fda, Aa, Ss, Ss, Aa, Aa, Sm, Aa^Esa, Aa^Qhh, Aa^Qhh
Aa^Qhux, Sm^Qhux, Sm^Qhux, Sm^Qhux, Aa^Fda, Aa^Fda, Ss, Aa, Aa^Esa, Aa, Aa^Esa, Aa, Sm^Qhux, Gll^Feth, Sm^Qhux, Sm^Qhux, Aa, Aa, Ss, Ss, Ss, Ss, Aa^Esa, Ss, Ss, Aa, Sm, Sm, Ss, Aa, Aa, Aa, Aa, Ss, Sm, Sm, Ai, Ai, Aa^Qhh, Aa^_mhh
Sm^Qhux, Sm^Qhux, Aa^Qhux, Sm^Qhux, Aa^Fda, Ss, Aa^Esa, Ss^Esa, Aa, Aa^Esa, Aa, Sm^Qhux, Sm^Qhux, Sm^Qhux, Sm^Qhux, Aa, Sm, Aa, Aa, Aa, Ss, Aa^Esa, Aa^Esa, Aa, Sm, Sm, Sm, Aa, Aa, Ss, Aa, Aa, Aa, Sm, Aa, Sm, Ss, Ai, Aa^Fda, Aa^Qhh
Sm^Qhux, Sm^Qhux, Aa, Aa, Aa, Ss, Aa, Aa^Esa, Aa^Esa, Aa^Esa, Ss, Sm, Aa, Sm^Qhux, Sm, Sm, Sm, Ss, Ss, Ss, Ai, Ai, Ai^Esa, Aa^Esa, Sm, Aa, Sm, Aa, Aa, Aa, Ss, Ss, Aa, Sm^Bw\r, Ss^Vhs, Ss^Bw/r, Sm^Bw\r, Aa^Fda, Aa^Fda, Aa
Ss^Qhux, Ss^Qhux, Aa, Aa, Ss^Vhs, Aa, Aa, Aa, Ss, Ss, Ss, Ss, Aa, Aa, Sm, Aa, Aa, Aa, Aa, Aa, Ai^Bw\r, Ai^Esa, Aa^Esa, Aa^Esa, Sm, Sm, Ss, Ss, Ss, Ss, Ai, Aa, Ai, Sm, Sm, Ss, Aa^Es, Sm^Bw\r, Sm^Bw\r, Sm
Ss^Qhux, Sm^Qhux, Aa^Esa, Aa, Ss, Ss^Bw\r, Ss^Bw\r, Ss, Aa, Ss, Ss, Aa, Ss, Aa, Sm, Aa, Sm, Aa, Aa, Ss, Ai^Esa, Ai^Bw\r, Ai^Bw\r, Aa, Ss, Sm, Aa, Ss, Ss, Ai, Aa^Esa, Ai^Esa, Aa^Esa, Ss, Aa, Sm, Sm, Sm, Ss, Aa
Sm^Qhux, Ss^Qhux, Aa, Aa^Esa, Aa, Ss, Ss, Aa, Aa, Aa, Ss, Ss, Aa, Ss, Sm^Bw/r, Sm^Bw|r, Sm, Aa, Ss, Ai, Aa, Aa, Aa^Esa, Ss^Vhs, Ss^Bw\r, Ss^Bw/r, Aa, Ss^Bw\r, Aa, Aa^Esa, Aa^Esa, Aa^Esa, Aa, Aa, Ss, Aa, Aa, Aa, Aa^Fda, Aa
Ss^Qhux, Sm^Qhux, Aa, Aa^Esa, Aa^Esa, Ss, Aa, Aa, Ss^Vhs, Aa, Ss, Ss, Aa, Aa, Sm, Aa, Aa, Aa, Ss^Qhux, Ss^Qhux, Sm, Sm^Esa, Sm, Ss, Ss, Ss, Ss, Ss, Aa, Aa, Ss, Aa^Esa, Aa^Fda, Aa, Ss, Ss, Ss, Ss, Aa^Esa, Aa^Fda
Sm^Qhux, Aa^Qhux, Sm^Qhux, Aa, Aa^Fda, Ss, Aa^Esa, Aa, Aa^Es, Ss^Bw\r, Ai^Bw\r, Ss^Bw/r, Ai, Sm, Sm, Sm, Aa, Aa, Ss^Qhux, Ss^Qhux, Aa, Aa, Ai, Sm, Sm, Aa, Aa^Fda, Aa, Aa, Ss, Ss, Aa^Fda, Aa^Fda, Aa^Fda, Aa^Fda, Aa, Sm, Ss, Aa^Esa, Aa^Esa
Ss^Qhux, Ss^Qhux, Ss^Qhux, Aa^Fda, Sm^Qhux, Aa, Aa^Esa, Aa^Esa, Aa, Aa^Es, Aa, Aa, Ai, Ai, Aa, Ss, Aa, Ss^Qhux, Aa, Aa^Es, Ai, Ai, Ai, Sm, Aa, Aa^Fda, Aa, Aa, Ss, Ss, Aa, Aa^Fda, Aa, Ss, Aa, Sm, Sm, Ai, Ai, Aa^Qhh
Ss, Ss^Qhux, Sm^Qhux, Sm^Qhux, Aa^Qhux, Sm^Qhux, Sm^Qhux, Aa^Esa, Aa, Aa, Aa, Ai, Ai, Sm, Ai, Ai, Aa, Aa, Aa, Aa, Aa, Ai, Ai, Aa, Aa, Aa, Aa, Ss, Aa, Aa, Ss, Aa, Ss, Ss, Ss, Sm, Aa, Ai, Ai, Aa^Qhh
