Xoc, Xoc, Xoc, Xoc, Xoc, Xoc, Xoc, Xoc, Xoc, Xoc, Xoc, Xoc, Xoc, Xoc, Xoc, Xoc, Xoc, Xoc, Xoc, Xoc, Xoc, Xoc, Xue, Xoc, Xoc, Xoc, Xoc
Xoc, Xoc, Xoc, Xoc, Xoc, Xoc, Xoc, Xoc, Xoc, Xoc, Xoc, Xoc, Xoc, Xoc, Xoc, Xoc, Xoc, Xoc, Xoc, Xoc, Xoc, Xoc, Xue, Xue, Xoi, Xu, Xu
Xoc, Xoc, Xoc, Xoc, Xoc, Xoc, Xoc, Xoc, Xoc, Xoc, Xoc, Xoc, Isr, Isr^Ebn, Isr, Xoc, Xoc, Xoc, Xoc, Xoc, Xoc, Xoc, Xoc, Xoi, Xu, Xu, Xu
Xoc, Xoc, Xoc, Xoc, Xoc, Xoc, Xoc, Xoc, Xoc, Xoc, Xoc, Xoc, Isr^Ebn, Urb, Isr^Ebn, Xoc, Xoc, Xoc, Xoc, Xoc, Xoc, Xoc, Xoc, Xu, Xu, Xu, Xu
Xoc, Xoc, Xoc, Xoc, Xoc, Xoc, Xoc, Xoc, Xoc, Xoc, Xoc, Xoc, Xoc, Isr, Xoc, Xoc, Xoc, Xoc, Xoc, Xoc, Xoc, Xoc, Xue, Xu, Xu, Xu, Xu
Xu, Xoc, Xoc, Xoc, Xoc, Xoc, Xoc, Xoc, Xos, Xoc, Xu, Xoc, Xos, Xos, Xos, Xoc, Xu, Xoc, Xu, Xoc, Xu, Xu, Xu, Xu, Xu, Xu, Xu
Xu, Xu, Xu, Xoc, Xu, Xoc, Xu, Xoc, Xos, Xos, Xoc, Xoc^Efs, Iwo, Iwo, Iwo, Xos, Xoc, Xos, Xos, Xoc, Xoc, Xoc, Xoc, Xu, Xu, Xu, Xu
Xu, Xu, Xu, Xu, Xu, Xoc, Xos, Xoc^Efs, Iwo, Iwo, Iwr, Iwo, Iwo, Iwo, Iwo, Iwo, Iwr, Uu^Vu, Uu, Xoc^Efs, Xos, Xoc, Xoc, Xoc, Xu, Xu, Xu
Xu, Xu, Xu, Xu, Xoc, Xoc, Iwo, Iwo, Qxu, Iwo, Iwo, Iwo, Cud, Cud, Cud, Iwr, Uu, Uu, Qxu, Uu, Uu, Xoc, Xoc, Xoc, Xoc, Xu, Xu
Xu, Xu, Xu, Xu, Xoc, Xos, Uu, Uu, Qxu, Qxu, Uu, Iwo^Eb, Cud, Kud, Cud, Iwo^Eb, Uu, Qxu, Qxu, Uu, Uu, Xoc, Xu, Xu, Xu, Xu, Xu
Xu, Xu, Xu, Xu, Xoc, Xos, Uu, Uu, Uu, Qxu, Uu^Vud, Iwo, Iwo, Cud, Iwo, Iwo, Uu^Vu, Qxu, Uu, Uu, Uu, Xoc, Xu, Xu, Xu, Xu, Xu
Xu, Xu, Xoc, Xoc, Xoc, Xoc, Uu^Eb, Uu, Uu, Urb, Urb, Iwr, Iwo, Iwo^Eb, Iwo, Iwo, Urb, Urb, Uu, Uu^Es, Uu^Eb, Xoc, Xu, Xu, Xu, Xu, Xu
Xu, Xu, Xu, Xoc, Xoc, Xoc, Xoc, Xoc^Efs, Uu, Urb, Urb, Xoc^Efs, Xos, Xoc, Xos, Xoc^Efs, Urb, Urb, Uu, Xoc^Efs, Xoc, Xoc, Xu, Xu, Xu, Xu, Xu
Xu, Xu, Xu, Xu, Xu, Xu, Xos, Uu, Tb^Tf, Uu^Es, Uu^Eb, Urb, Uu, Tb^Tf, Uu, Urb, Uu^Eb, Uu, Tb^Tf, Uu, Xos, Xoc, Xoc, Xu, Xu, Xu, Xu
Xu, Xu, Xu, Xu, Xu, Xu, Xos, Uu, Uu, Qxu, Qxu, Urb, Uu, Tb^Tf, Tb^Tf, Urb, Qxu, Qxu, Tb^Tf, Tb^Tf, Xos, Xoc, Xoc, Xu, Xu, Xu, Xu
Xu, Xu, Xu, Xu, Xu, Xu, Xu, Uu, Uu, Qxu, Uu^Dr, Urb, Xos, Tb^Tf, Xu, Urb, Uu^Vud, Qxu, Uu, Uu, Xos, Xos, Xoc, Xu, Xu, Xu, Xu
Xu, Xu, Xu, Xu, Xu, Xu, Xoc, Xu, Uu^Vu, Uu, Urb, Urb, Xoc, Tb^Tf, Xu, Urb, Urb, Uu, Rrd^Dr, Xoc, Xoc, Xu, Xoc, Xu, Xu, Xu, Xu
Xu, Xu, Xu, Xu, Xu, Xu, Xu, Xoc, Xu, Uu, Urb, Xos, Xos, Xoc, Xoc, Xu, Urb, Uu, Xoc, Xoc, Xu, Xu, Xu, Xu, Xu, Xu, Xu
Xu, Xu, Xu, Xu, Xu, Xu, Xu, Xoc, Xos, Urb, Uu, Xos, Xos, Xoc, Xoc^Efs, Xoc, Uu^Es, Urb, Xos, Xos, Xu, Xos, Xu, Xu, Xu, Xu, Xu
Xu, Xu, Xu, Xu, Xoc, Xos, Xoc^Efs, Xos, Urb, Urb, Uu, Uu, Gll^Fdw, Uu^Eb, Tb^Tf, Uu, Uu, Urb, Urb, Xoc, Xoc^Efs, Xoc, Xoc, Xos, Xu, Xu, Xu
Wo, Wo, Wo, Xoc, Xoc, Gll^Fdw, Uu^Es, Uu, Urb, Uu, Ww, Ww, Ww, Gll^Fdw, Ww, Ww, Ww, Uu, Urb, Uu, Uu, Gll^Fdw, Xu, Xu, Xu, Xu, Xu
Wo, Wo, Wo, Wo, Wo, Ww, Ww, Ww, Ww^Bw|r, Ww, Wo, Wo, Wo, Ww, Wo, Wo, Wo, Ww, Ww^Bw|, Ww, Ww, Ww, Wo, Wo^Dr, Xu, Wo^Dr, Xu
Xu, Xu, Xos, Wo, Uu, Ww, Uu, Uu, Urb, Ww, Ww, Wo, Ww, Gd^Fetd, Ww, Wo, Ww, Ww, Urb, Uu, Uu, Ww, Uu, Wo, Xos, Xu, Xu
Xu, Xu, Xoc, Xos, Gll^Fdw, Uu, Gg^Ve, Urb, Urb, Gll^Fdw, Gll^Fdw, Ww, Gll^Fdw, Ww, Gll^Fdw, Ww, Tb^Tf, Tb^Tf, Urb, Urb, Uu^Dr, Uu, Tb^Tf, Xos, Xoc, Xu, Xu
Xu, Xu, Xu, Xos, Xos, Gll^Fdw, Gll^Fdw, Urb, Urb, Uu, Xos, Gll^Fdw, Xos, Tb^Tfi, Xos, Tb^Tf, Xos, Tb^Tf, Urb, Urb, Gll^Fdw, Gll^Fdw, Xoc, Xos, Xu, Xu, Xu
Xu, Xu, Xu, Xu, Xoc, Xos, Xos, Xos, Gll^Fdw, Urb, Uu^Edb, Xoc^Efs, Xos, Xos, Xos, Xoc^Efs, Uu, Urb, Gll^Fdw, Xos, Xos, Xos, Xoc, Xu, Xu, Xu, Xu
Xos, Xu, Xu, Xu, Xu, Xoc, Xos, Gll^Fdw, Xoc^Efs, Urb, Uu^Edb, Uu^Edb, Ur^Edt, Uu^Vu, Ur^Edt, Ur^Edt, Ur^Edt, Urb, Xos, Gll^Fdw, Xos, Xu, Xu, Xu, Xu, Xu, Xos
Xos, Xos, Xos, Xu, Xu, Xoc, Xos, Gll^Fdw, Gll^Fdw, Urb, Urb^Edt, Ur^Edb, Cud, Ur^Eb, Cud, Ur^Edt, Urb^Edt, Urb^Edt, Gll^Fdw, Tb^Tf, Xos, Xu, Xu, Xu, Xos, Xos, Xos
Xos, Xos, Xos, Xos, Xos, Xoc, Xoc, Xos, Xos, Uu^Vu, Uu^Edt, Urb^Edt, Cud^Edt, Kud^Edt, Cud^Edt, Urb^Edt, Uu^Edt, Uu^Vu, Xos, Xos, Xoc, Xoc, Xos, Xos, Xos, Xos, Xos
Xos, Xos, Xos, Xos, Xos, Xos, Xos, Xu, Xos, Xos, Uu^Eb, Urb^Edt, Urb, Cud^Edt, Urb^Edt, Urb^Edt, Uu^Edt, Xos, Xoc, Xu, Xos, Xos, Xos, Xos, Xos, Xos, Xos
Xos, Xos, Gll, Xos, Gll, Xos, Gll, Xos, Xos, Xos, Xos, Uu^Edt, Urb, Urb^Edt, Urb^Edt, Uu, Xos, Xos, Xos, Xos, Gll, Xos, Gll, Xos, Gll, Xos, Xos
Gll, Gll, Gll, Gll, Gll, Gll, Gll^Fmf, Gll, Gll, Xos, Xos, Xos, Rp^Edb, Urb^Edb, Rp^Edb, Xos, Xos^Edb, Xos, Gll, Gll, Gll, Gll, Gll, Gll, Gll, Gll, Gll
Gll, Gll, Gll, Gll^Fmf, Gll^Fmf, Gll, Gll^Fmf, Gll, Gll, Gll, Gll^Edb, Rp^Edb, Rp^Edb, Rp^Edb, Rp^Edb, Rp^Edb, Rp, Gll, Cer^Edb, Gll^Edb, Gll, Gll^Fmf, Gll, Gll^Fmf, Gll, Gll, Gll^Fmf
Rp, Gll, Gll, Gll, Gll^Fmf, Gll, Gll^Fmf, Gll^Fmf, Gll^Fmf, Gll, Gll, Rp^Edb, Gll^Edb, Rp^Edb, Rp^Edb, Rp^Edb, Gll, Cer^Edb, Ker^Edb, Cer^Edb, Gll^Fmf, Gll, Gll, Gll, Gll, Gll, Gll^Fmf
Gll, Rp, Rp, Gll, Gll, Gll^Fmf, Gll, Gll, Gll, Gll^Fmf, Gll, Gll, Gll^Edb, Rp^Edb, Rp, Rp, Rp, Cer^Edb, Cer^Edb, Cer, Gll, Gll, Gll, Gll, Gll^Fmf, Gll^Fmf, Gll
Gll, Gll, Gll, Rp, Rp, Gll, Gll, Gll^Fmf, Gll^Fmf, Gll, Gll^Fmf, Gll, Gll, Gll, Gll, Gll, Rp, Rp^Edb, Gll^Edb, Gll, Gll^Fmf, Gll, Gll, Gll, Gll^Fmf, Gll^Fmf, Gll
Gll, Gll, Gll, Gll, Rp, Gll, Gll, Gll^Fmf, Cer^Edb, Gll, Gll^Fmf, Gll^Fmf, Gll, Gll^Fmf, Gll, Gll, Rp, Rp^Edb, Gll^Edb, Gll^Edb, Gll, Gll, Gll, Gll^Fmf, Gll^Fmf, Gll^Fmf, Gll^Fmf
Gll^Fmf, Gll, Gll^Fmf, Gll, Gll, Rp, Rp, Cer^Edb, Ker^Edb, Cer^Edb, Gll, Gll^Fmf, Gll, Gll, Gll, Gll, Gll, Rp, Rp, Gll^Edb, Gll, Rp, Gll, Gll, Gll^Fmf, Gll^Fmf, Gll
Gll, Gll^Fmf, Gll^Fmf, Gll^Fmf, Gll^Fmf, Gll, Rp, Cer^Edb, Cer, Cer^Edb, Gll^Edb, Gll, Gll, Gll, Gll, Gll, Rp, Gll, Rp, Rp, Rp, Rp, Gll, Gll, Gll^Fmf, Gll^Fmf, Gll
Gll, Gll^Fmf, Gll^Fmf, Gll^Fmf, Gll, Gll^Fmf, Gll, Rp, Rp, Rp^Edb, Rp^Edb, Rp, Rp, Rp, Rp, Rp, Gll, Rp, Gll, Rp, Rp, Gll, Gll, Gll^Fmf, Gll^Fmf, Gll, Gll^Fmf
Gll, Gll, Gll^Fmf, Gll^Fmf, Gll^Fmf, Gll^Fmf, Gll^Fmf, Gll, Gll, Gll, Gll^Fmf, Gll, Gll^Fmf, Gll^Fmf, Gll^Fmf, Gll, Gll^Fmf, Gll, Gll^Fmf, Gll, Rp, Rp, Gll, Gll, Gll, Gll^Fmf, Gll^Fmf
Gll, Gll, Gll, Gll^Fmf, Gll, Gll^Fmf, Gll, Gll, Gll, Gll, Gll, Gll^Fmf, Gll, Gll^Fmf, Gll, Gll^Fmf, Gll, Gll^Fmf, Gll, Gll, Rp, Rp, Rp, Rp, Gll, Gll, Gll
