Sm, Ss, Ss, Aa, Aa, Aa^Qhu, Aa, Aa^Fda, Aa^Feta, Aa^Fda, Aa^Fda, Ai, Ai, Aa, Ai, Ai, Aa^Qhh, Aa^Qhh, Aa^Qhh, Aa^Qhh, Aa^Qhh, Aa^Qhh, Aa^Qhh, Aa^Qhh, Aa^Qhh, Ai, Aa^Qhh, Aa^Qhh, Aa^Qhh
Sm, Sm, Sm, Ss, Ww^Wkf, Ww^Qhu, Ww, Aa, Aa, Aa^Fda, Aa, Aa^Fda, Ai, Ai, Aa^Qhh, Aa^Qhh, Aa, Aa, Aa^Esa, Aa, Aa, Aa^Es, Aa, Aa, Aa, Aa^Qhh, Aa^Fda, Aa^Fda, Aa^Fda
Sm, Sm, Sm, Ss, Aa^Efm, Aa^Qhu, Aa, Ww, Ai, Aa, Ai, Ai, Aa^Qhh, Ch^Qhh, Re, Aa, Aa, Aa, Aa, Aa, Aa^Efm, Aa, Aa^Esa, Aa^Esa, Aa^Esa, Aa, Aa, Aa^Fda, Aa^Fda
Ss, Aa^Es, Aa, Aa, Aa^Efm, Aa^Qhu, Aa^Efm, Aa^Efm, Ww, Ai, Aa^Qhh, Aa^Qhh, Aa, Aa, Aa, Re, Re, Aa^Es, Aa, Aa, Aa, Aa^Efm, Aa, Aa, Aa^Vwm, Aa, Aa, Aa, Aa^Eff
Gg, Ss, Ss, Ss, Aa, Aa^Qhu, Aa^Efm, Aa, Ai, Aa^Qhh, Aa^Efm, Aa^Efm, Aa^Efm, Aa^Efm, Aa, Aa, Aa^Ebn, Re, Re, Aa^Vha, Aa, Aa^Efm, Aa^Efm, Aa^_mh, Aa, Aa, Aa^Eff, Aa^Eff, Re^Gvs
Sm, Ss^Vhs, Sm, Sm, Ww^Wkf, Aa^Qhu, Aa, Aa, Ai, Aa^Qhh, Aa^Es, Aa^Efm, Aa^Efm, Aa, Re, Aa, Re, Re, Cha, Re, Re, Aa, Aa^Efm, Aa, Aa^Eff, Aa^Eff, Re^Gvs, Re^Gvs, Re^Gvs
Sm, Sm, Sm, Sm, Ai, Ww^Qhu, Ww, Aa, Ai, Aa^Qhh, Aa, Aa, Re, Re, Re, Re, Aa, Cha, Kea, Cea, Re, Re, Aa, Aa, Aa^Eff, Aa^Eff, Re^Gvs, Re^Gvs, Re^Gvs
Ss, Ss, Ss, Ai, Aa^Qhu, Aa^Qhu, Aa, Ai, Aa^Qhh, Aa^Qhh, Re, Re, Aa, Aa^Vha, Aa, Re, Aa, Cea, Cea, Cea, Re, Re, Aa^Eff, Aa^Eff, Re^Gvs, Re^Gvs, Re^Gvs, Re^Gvs, Re^Gvs
Ss, Ss, Aa, Ai, Aa^Qhu, Aa^Efm, Aa^Efm, Aa, Aa^Qhh, Re, Aa^Vha, Aa^Fda, Aa, Aa, Aa, Re, Aa, Aa, Aa, Aa, Aa^Vha, Re, Aa, Aa^Eff, Re, Re^Gvs, Re^Gvs, Re^Gvs, Re^Gvs
Gg, Ss, Aa^Qhu, Aa^Qhu, Aa, Aa, Aa, Aa, Re^Qhh, Re, Re, Aa, Aa, Aa^Esa, Aa, Re, Re, Aa, Aa, Aa, Ai, Re, Re, Re, Aa^Fda, Aa^Eff, Aa^Eff, Re^Gvs, Re^Gvs
Sm, Ss, Aa^Qhu, Aa, Aa^Es, Aa^Fda, Aa^Fda, Aa, Aa^Qhh, Aa, Aa, Re, Re, Aa, Aa, Aa, Aa, Aa^Vha, Aa^Efm, Ai, Ai, Ai, Aa, Re, Re, Re, Aa^Vha, Aa^Eff, Aa^Eff
Sm, Aa, Aa^Qhu, Aa, Aa, Aa^Fda, Aa^Fda, Aa, Aa^Qhh, Aa, Aa, Aa^Esa, Aa, Re, Aa, Aa^Esa, Aa, Aa^Efm, Aa, Ai, Ai, Ai, Aa, Aa, Re, Aa, Aa, Aa, Aa
Sm, Sm, Aa^Qhu, Aa, Aa, Aa^Fda, Aa^Esa, Aa, Aa, Aa^Qhh, Aa^Qhh, Aa, Aa, Re, Aa^Wm, Aa^Fda, Aa, Aa^Fda, Aa^Fda, Aa, Aa^Vh, Aa^Ecf, Aa^Fda, Aa^Fda, Re, Aa^Es, Aa, Aa, Aa
Aa, Sm, Sm, Aa^Qhu, Aa^Qhu, Aa, Aa, Aa^Esa, Aa, Aa, Aa^Qhh, Aa^Es, Aa, Re, Re, Aa, Aa, Aa^Esa, Aa^Esa, Aa^Esa, Aa, Re, Re, Re, Re, Aa, Aa^Efm, Aa^Efm, Aa^Efm
Ss, Sm, Aa^Es, Aa, Aa, Aa^Qhu, Aa^Qhu, Aa, Aa, Aa, Aa, Aa^Qhh, Aa, Aa^Vha, Aa, Re, Re, Aa, Aa, Aa, Aa^Es, Aa^Fda, Re, Aa, Re, Aa, Aa^Efm, Aa^Efm, Aa
Aa, Ss, Ai, Ai, Ai, Aa, Aa^Fda, Aa^Qhu, Aa, Aa, Aa, Aa^Qhh, Aa^Qhh, Aa, Aa, Aa^Fda, Aa, Re, Re, Aa, Re, Re, Aa^Es, Re, Re, Aa, Aa, Aa, Aa
Aa, Ss, Ss, Ss^_ml, Ss, Aa^Fda, Aa^Fda, Aa^Qhu, Aa, Ai, Ai, Ai, Aa^Qhh, Aa, Aa^Efm, Aa^Efm, Aa^Efm, Aa, Aa, Re, Cea, Aa, Aa, Aa, Re, Aa^Ecf, Aa, Aa, Ai
Aa, Aa, Ss, Ss, Sm, Aa^Fda, Aa, Aa^Qhu, Aa^Qhu, Aa, Aa, Aa, Aa^Qhh, Aa, Aa, Aa, Aa^Efm, Aa, Aa, Cea, Kea, Aa, Aa, Aa, Aa^Vh, Aa, Ai, Ai, Aa
Ss, Ss, Aa, Aa, Sm, Aa^Esa, Aa^Qhu, Aa^Qhu, Aa, Aa, Aa, Aa, Aa, Aa^Qhh, Aa^Qhh, Aa, Aa, Aa, Aa, Aa, Re, Aa, Aa, Aa, Aa, Aa, Aa, Aa, Aa
Aa, Ss, Sm, Sm, Ai, Ai, Aa^Qhu, Aa, Aa, Aa, Aa^Esa, Aa^Esa, Aa, Aa, Aa^Qhh, Aa^Qhh, Aa^Qhh, Aa, Aa, Aa, Re, Aa, Aa^Qhh, Aa, Aa^Qhh, Aa^Qhh, Aa^Qhh, Aa, Aa
Aa, Sm, Aa, Sm, Ss, Ai, Aa^Fda, Aa^Qhu, Aa^Qhu, Aa^Esa, Aa, Aa^Esa, Aa, Aa, Aa, Aa, Aa, Aa^Qhh, Aa^Qhh, Re, Aa^Qhh, Aa^Qhh, Aa, Aa^Qhh, Aa, Aa, Aa, Aa^Qhh, Aa^Qhh
Aa, Sm, Ss^Vhs, Ss, Sm, Aa^Fda, Aa^Fda, Aa, Ww, Aa^Qhu, Aa^Qhu, Aa, Aa, Aa, Aa^Es, Aa, Aa, Aa, Aa, Re^Qhh, Aa, Aa, Re, Aa, Re, Re, Re, Aa, Aa
Aa, Sm, Sm, Ss, Aa^Es, Sm, Sm, Sm, Ai, Ww, Ww^Qhu, Ww, Ai, Aa, Aa, Aa, Aa, Aa, Aa, Re, Re, Re, Aa, Re, Aa, Aa, Aa, Re, Re
Aa, Ss, Aa, Sm, Sm, Sm, Ss, Aa, Aa^Esa, Ww, Aa^Qhu, Aa, Aa, Ai, Ww, Aa, Ai, Aa, Re, Re, Ww, Aa, Ww, Aa, Ai, Aa, Ai, Ai, Ai
Aa, Aa, Ss, Aa, Aa, Aa, Aa^Fda, Aa, Aa^Fda, Aa, Aa^Qhu, Aa, Aa, Aa, Aa, Ai, Aa, Ww, Ai, Ww^Bw\, Aa, Ww, Ww, Ai, Aa, Ai, Aa, Aa, Aa
Aa, Aa, Ss, Ss, Ss, Ss, Aa^Esa, Aa^Fda, Aa^Qhu, Aa^Qhu, Aa, Aa, Aa^Fda, Aa, Aa^Fda, Aa, Aa, Aa, Ai, Aa^Fda, Aa^Fda, Aa^Vla, Aa^Feta, Ww, Aa, Aa, Aa, Aa^Fda, Aa
Aa, Aa, Aa, Aa, Sm, Ss, Aa^Esa, Aa^Esa, Aa^Qhu, Aa, Aa^Fda, Aa^Fda, Aa^Esa, Aa^Fda, Aa^Esa, Aa^Fda, Aa, Ai, Ww, Ai, Wo, Aa^Fpa, Aa^Fpa, Ww, Aa, Aa, Aa^Fda, Aa^Fda, Aa
Aa, Ss, Aa, Sm, Sm, Ai, Ai, Aa^Qhu, Aa, Aa, Aa, Aa^Fda, Aa^Feta, Aa^Esa, Aa, Aa^Esa, Aa, Aa, Aa, Aa, Aa, Wo, Wo, Wo, Aa, Aa^Fda, Aa, Aa^Fda, Aa^Fda
Ss, Ss, Ss, Sm, Aa, Ai, Ai, Aa^Qhu, Aa, Aa, Aa, Aa, Aa, Aa, Aa, Aa, Aa, Aa, Aa, Aa, Aa, Aa, Aa, Aa, Aa, Aa, Aa, Aa^Fda, Aa
