Xoi, Xoi, Xoi, Xoi, Xoi, Xoi, Xoi, Xoi, Xoi, Xoi, Xoi, Xoi, Xoi, Xoi, Xoi, Xoi, Xoi, Xoi, Xoi, Xoi, Xoi, Xoi, Xoi, Xoi, Xoi, Xoi, Xoi, Xoi, Xoi, Xoi, Xoi, Xoi, Xoi, Xoi, Xoi, Xoi, Xoi, Xoi, Xoi
Xoi, Xoi, Xos, Xos, Xos, Xos, Xoi, Xoi, Iwc, Xoi, Xoi^Efs, Xoi, Xoi, Xos, Xos, Xos, Xos, Xos, Xos, Xos, Xos, Xos, Xos, Xos, Xos, Xos, Xoc, Xoc, Xoc, Xoc, Xu, Xoc, Xoc, Xoc, Xue, Xoc, Xoc, Xoc, Xoc
Xoi, Xoi, Xos, Xos, Xoi, Xoi, Iwc, Xoi, Xoi^Efs, Iwr, Iwr, Xoi, Xoi, Xoi, Xos, Xos, Xos, Xos, Xos, Xos, Xos, Xos, Xue, Xue, Xue, Xue, Xoi, Xu, Xu, Xu, Gg, Xu, Xu, Xue, Xue, Xoc, Xoc, Xoc, Xoc
Xoi, Xoi, Xoi, Xoi, Iwc, Xoi, Xoi^Efs, Iwr, Iwr, Iwr, Xoi, Iwr, Iwc, Xoi, Xoi, Xoi, Xoi, Xos, Xos, Xos, Xos, Xue, Xue, Xue, Xue, Xue, Xu, Xu, Qxua, Gg, Qxua, Qxua, Qxua, Xu, Xu, Xue, Xue, Xoc, Xoc
Xoi, Xoi, Iwc, Xoi, Xoi^Efs, Iwr, Iwr, Iwr, Xoi, Iwr, Iwc, Xoi, Xoi, Xoi, Xoi, Xoi, Xoi, Xos, Xos, Xos, Xos, Xue, Xue, Xue, Xue, Xue, Xu, Xu, Qxua, Qxua, Xu, Qxua, Qxua, Qxua, Gg, Xu, Xue, Xoc, Xoc
Xoi, Xoi, Xoi, Iwr, Iwr, Iwr, Xoi^Efs, Iwr, Iwc, Xoi, Xoi, Xoi, Xoi, Xos, Xos, Xoi, Xos, Xos, Xos, Xos, Xos, Xue, Xue, Xue, Xue, Xue, Xu, Xu, Qxua, Xu, Qxua, Qxua, Gg, Qxua, Qxua, Gg, Xue, Xoc, Xu
Xoi, Xoi, Iwr, Iwr, Iwr, Iwr, Iwr, Xoi, Xoi^Efs, Xoi, Xoi, Xoi, Xoc, Xoi, Xoc, Xoc, Xoc, Xu, Xoc, Xos, Xu, Xu, Xue, Xue, Qxua, Qxua, Iwc^Ii, Iwc, Xu, Xu, Qxua, Qxua, Qxua, Qxua, Qxua, Qxua, Xue, Xu, Xu
Xoi, Iwc, Xoi, Xoi, Iwr, Xoi, Xoi, Iwr, Iwr, Xoi, Xoi, Xoc, Isr^Qhh, Xoc^Efs, Isr^Qhh, Isr^Qhh, Isr^Qhh, Xoc^Efs, Isr^Qhh, Xoc, Xoc, Xoc, Qxua, Qxua, Qxua, Qxua, Qxua, Xu, Xu, Xu, Gg, Qxua, Qxua, Qxua, Gg, Qxua, Xu, Xu, Xu
Xoi, Xoi, Xoi, Xoi, Iwc, Xoi, Xoi, Xoi, Xoi, Rr^Pr/o, Isr^Qhh, Isr^Qhh, Isc^Vhc, Isr^Qhh, Isc, Isc, Isc, Isr^Qhh, Isc^Vhc, Isr^Qhh, Isr^Qhh, Qxua, Qxua, Qxua, Qxua, Qxua, Qxua, Qxua, Xu, Xu, Gg, Qxua, Qxua, Gg, Qxua, Qxua, Xu, Xu, Xu
Xoi, Xoi, Xoi, Xoi, Xoi, Xoi, Xoi, Xoi, Isr^Qhh, Isr^Qhh, Isr, Isr, Ww, Isc, Cud, Cud, Cud, Isc, Ww, Isr^_mhh, Isr, Isr^Qhh, Isr^Qhh, Qxua, Qxua, Qxua, Xue, Qxua, Xu, Xu, Qxua, Qxua, Qxua, Qxua, Qxua, Qxua, Xu, Xu, Xu
Xoi, Xoi, Xoi, Xoi, Xoi, Xoi, Urb, Rr^Pr\, Xoc, Isr^Qhh, Isr^Ebn, Ww, Isc, Isc^Ebn, Cud, Gg^Fet, Cud, Isc^Ebn, Isc, Ww, Isr^Ebn, Isr, Isr^Qhh, Qxua, Xoc, Xue, Xoi, Xue, Xu, Xu, Xu, Qxua, Qxua, Qxua, Gg, Xu, Xu, Xu, Xu
Xoi, Xoi, Xoi, Xoi, Xoi, Urb, Xoi, Urb, Xoc, Isr^Qhh, Isr, Ww, Isc^Vhc, Isc, Isc, Cud, Isc, Isc, Isc^Vhc, Ww, Isr, Isr, Isr^Qhh, Xoc, Xoi, Xoi, Xoi, Xoi, Xu, Xu, Qxua, Qxua, Qxua, Gg, Xu, Xu, Xu, Xu, Xu
Xoi, Xoi, Xoi, Xoi, Xoi, Urb, Xoi, Urb, Xoc, Isr^Qhh, Isr^Qhh, Isr^Qhh, Isr^Qhh, Isc^Qhh, Isc^Qhh, Isc^Qhh, Isc^Qhh, Isc^Qhh, Isr^Qhh, Isr^Qhh, Isr^Qhh, Isr^Qhh, Xoc, Xoc, Xoi, Xoi, Xoi, Xoi, Xu, Xu, Qxua, Qxua, Qxua, Qxua, Xu, Xu, Xu, Xu, Xu
Xoi, Xoi, Xoi, Xoi, Urb, Urb, Urb, Urb, Xoc, Xoc^Efs, Isa, Isa, Isa, Xoc, Xoc^Efs, Xoc, Xoc^Efs, Xoc, Isa, Isa, Isa, Xoc^Efs, Xoc, Xoc, Xoi, Xoi, Xoi, Xoi, Xu, Xu, Gg, Qxua, Qxua, Xu, Xu, Xu, Xu, Xu, Xu
Xoi, Xoi, Xoi, Xoi, Urb, Xoi, Urb, Xoi, Xoc, Tb^Tf, Uu, Uu, Uu, Isa, Urb, Uu^Ebn, Urb, Isa, Uu, Uu, Uu, Tb^Tf, Xoc, Xoi, Xoi, Xoi, Xoi, Xoi, Xu, Xu, Qxua, Gg, Qxua, Qxua, Xu, Xu, Xu, Xu, Xu
Xoi, Xoi, Xoi, Xoi, Urb, Xoi, Urb, Xoi, Xoi, Tb^Tf, Uu, Wwt^Ii, Wwt^Ii, Ur, Urb, Uu^Emf, Urb, Ur, Wwt^Ii, Wwt^Ii, Uu, Tb^Tf, Xoc, Xoi, Xoi, Xoi, Xoi, Xoi, Xu, Qxua, Qxua, Qxua, Qxua, Qxua, Xu, Xu, Xu, Xu, Xu
Xoi, Xoi, Xoi, Xoi, Xoi, Urb, Xoi, Urb, Xoi, Tb^Tf, Uu, Wwt^Ii, Uu, Ur, Xoc, Uu^Emf, Xoc, Ur, Uu, Wwt^Ii, Uu, Tb^Tf, Xoi, Xoi, Xof, Xoi, Xoi, Xu, Xu, Qxua, Qxua, Qxua, Gg, Gg, Xu, Xu, Xu, Xu, Xu
Xoi, Xoi, Xoi, Xoi, Xoi, Urb, Xoi, Urb, Xoi, Xoc, Uu^Vud, Uu, Isa, Ur, Xoc, Uu^Emf, Xoc, Ur, Isa, Uu, Uu^Vud, Xoc, Xof, Xof, Iwr, Xof, Xof, Xu, Xu, Xu, Qxua, Qxua, Qxua, Qxua, Xu, Xu, Xu, Xu, Xu
Xoi, Xoi, Xoi, Xoi, Xoi, Urb, Urb, Urb, Xoi, Xoi, Xoc, Isa, Isa, Xoc, Xoa, Xoi, Xoi, Xoc, Isa, Isa, Xoc, Xof, Iwr, Iwr, Iwc, Iwr, Iwr, Xof, Xu, Xu, Qxua, Qxua, Qxua, Qxua, Xu, Xu, Xu, Xu, Xu
Xu, Xoi, Xue, Xoi, Xoi, Xos, Xos, Urb, Urb, Xoi, Xoc, Isa, Isa, Xoc^Efs, Xoc, Xoc, Xoc, Xoc^Efs, Isa, Isa, Xoc, Xof, Iwr, Iwr, Iwr, Iwr, Xof, Xoc, Xu, Xu, Qxua, Qxua, Qxua, Xu, Xu, Xu, Xu, Xu, Xu
Wo, Xu, Xu, Xu, Xu, Xoi, Xoc, Xoc, Xos^Efs, Rr^Pr/, Isa, Isa, Ur^Es, Isa, Gs^Fds, Uu^Ebn, Gs^Fds, Ur, Ur, Isa, Isa, Rr^Pr\, Xoc^Efs, Xof, Xoc, Xof, Xu, Xu, Xu, Xu, Gg, Xuf, Gg, Xu, Xu, Xu, Xu, Xu, Xu
Wo, Wo, Wo, Wo, Wo, Xu, Isa, Xoc, Isa, Isa, Isa, Ur^Es, Ww, Ww, Ww^Ii, Gs^Fds, Ww^Ii, Ww, Ww, Isa, Isa, Isa, Isa, Xoc, Isa, Xu, Wo, Wo, Wo, Hh, Gg, Gg, Gg, Hh, Xu, Xu, Xu, Xu, Xu
Wo, Wo, Wo, Wo, Wo, Wo, Wo, Isa, Ww^Bsb\, Ww, Ww, Ww, Wo, Wo, Wo^Ii, Ww^Ii, Wo^Ii, Wo, Wo, Ww, Ww, Ww, Ww^Bsb/, Isa, Wo, Wo, Wo, Wo, Wo, Hh, Gg, Gg^Fet, Gg, Hh, Xu, Xu, Xu, Xu, Xu
Xu, Wo, Xu, Xu, Xu, Wo, Uu, Ww, Uu, Ur, Uu, Ww, Ww, Wo, Ww^Ii, Gg^Fet, Ww^Ii, Wo, Ww, Ww, Uu, Ur, Uu, Ww, Uu, Wo, Xoc, Xu, Xu, Hh, Hh, Gg, Hh, Hh, Xu, Xu, Xu, Xu, Xu
Xoi, Xu, Xor, Xor, Xoi, Xor, Uu, Uu, Ur^Vud, Ur, Ur, Gs^Fds, Gs^Fds, Ww, Gs^Fds, Ww^Ii, Gs^Fds, Ww, Gs^Fds, Gs^Fds, Ur, Ur, Ur^Vud, Uu, Uu, Xoc, Xor, Xu, Xu, Xu, Xu, Xu, Xu, Xu, Xu, Xu, Xu, Xu, Xu
Xoi, Xoi, Xor, Xor, Xof, Xof, Rr^Pr\, Ur, Uu, Uu, Uu, Ur, Xoc^Qhh, Gs^Fds, Xoc^Qhh, Gs^Fds, Xoc^Qhh, Gs^Fds, Xoc^Qhh, Ur, Uu, Uu, Uu, Ur, Rr^Pr/, Xoc, Xoc, Xor, Xoi, Xu, Xu, Xu, Xu, Xu, Xu, Xu, Xu, Xu, Xu
Xoi, Xoi, Xor, Xor, Xof, Iwr, Xof, Xoc, Xoc^Qhh, Xoc^Qhh, Uu^Qhh, Ur^Qhh, Tb^Tf, Xoc^Qhh, Xoc^Efs, Xoc^Qhh, Xoc^Efs, Xoc^Qhh, Tb^Tf, Ur^Qhh, Uu^Qhh, Xoc^Qhh, Xoc^Qhh, Xoc, Xoc, Iwr^_s, Xoc, Xor, Xu, Xu, Xu, Xu, Xu, Xu, Xu, Xu, Xu, Xu, Xu
Xoi, Xoi, Xor, Xof, Iwr, Iwr, Iwr, Xof, Xoc^Qhh, Gs^Fds, Xoc^Efs, Ur, Ur, Tb^Tf, Ur, Ur^Vud, Ur, Tb^Tf, Ur, Ur, Xoc^Efs, Gs^Fds, Xoc^Qhh, Xoc, Xoc, Iwr^_s, Xoc, Xof, Xu, Xu, Xu, Xu, Xu, Xu, Xu, Xu, Xu, Xu, Xu
Xoi, Xoi, Xor, Xof, Iwr, Iwr, Iwr, Xof, Xoc^Qhh, Gs^Fds, Gs^Fds, Uu, Ur, Ur, Cud, Tb^Tfi, Cud, Ur^_mh, Ur, Uu, Gs^Fds, Gs^Fds, Xoc^Qhh, Xof, Xoc, Xoc, Xoc, Xoc, Xu, Xu, Xu, Xu, Xu, Xu, Xu, Xu, Xu, Xu, Xu
Xoi, Xoi, Xor, Xof, Iwr, Iwc^Ii, Iwr, Xof, Xoi^Qhh, Xoc, Xoc, Ur^Vud, Tb^Tf, Ur, Cud, Kud, Cud, Ur, Tb^Tf, Ur^Vud, Xoc, Xoc^Qhh, Xor, Xoc, Xoc, Xoc, Xoc, Xoc, Xoi, Xu, Xu, Xu, Xu, Xu, Xu, Xu, Xu, Xu, Xu
Xoi, Xoi, Xor, Xof, Xof, Iwr, Xof, Xof, Xor^Qhh, Xor, Xoi, Xoc, Tb^Tf, Ur, Ur, Cud, Ur, Ur, Tb^Tf, Xoc, Xoi, Xor^Qhh, Xor, Xoc, Xoc, Xoc, Xoc, Xof, Xu, Xu, Xu, Xu, Xu, Xu, Xu, Xu, Xu, Xu, Xu
Xoi, Xoi, Xor, Xor, Xor, Xof, Xor, Xor, Xor^Qhh, Xor, Xor, Xoc, Xoc, Xoc, Xoc, Ur, Xoc, Xoc, Xoc, Xoc, Xoi, Xoi^Qhh, Xoi, Xoc, Xoi, Xoc, Xoi, Xu, Xu, Xu, Xu, Xu, Xu, Xu, Xu, Xu, Xu, Xu, Xu
Xoi, Xoi, Xoi, Xor, Xor, Xor, Xor, Xor, Xor^Qhh, Xor, Xor, Xor, Xoi, Xor, Xoi, Ur, Xoc, Xoc, Xor, Xor, Xor, Xor^Qhh, Xoi, Xor, Xor, Xor, Xor, Xu, Xu, Xu, Xu, Xu, Xu, Xu, Xu, Xu, Xu, Xu, Xu
