Xoc, Xoc, Xoc, Xoc, Xoc, Xoc, Xoc, Xoc, Xoc, Xoc, Xoc, Xoc, Xoc, Xoc, Xoc, Xoc, Xoc^Qhh, Xoc, Xoc^Qhh, Xoc, Xoc, Xoc, Xoc, Xoc, Xoc, Xoc, Iwr, Iwr, Xoc, Xoc, Xoc, Xoc, Xoc, Xoc, Xoc, Xoc, Xom
Xoc, Xoc, Xoc, Xoc, Xoc, Xoc, Xoc, Xoc, Xoc, Xoc, Xoc, Xoc, Xoc, Xoc, Xoc^Qhh, Xoc^Qhh, Xoc^Exw, Xoc^Qhh, Xoc, Xoc^Qhh, Xoc, Xoc, Xoc, Xoc, Xoc, Xoc, Iwr, Iwr, Xoc, Xoc, Xoc, Xom, Xom, Xoc, Xoc, Xom, Xom
Xoc, Xoc, Xoc, Xoc, Xoc, Xoc, Xoc, Xoc, Xoc, Xoc, Xoc, Xoc, Xoc^Qhh, Xoc^Qhh, Xoc^Exw, Xoc^Exw, Ch^Efs, Xoc^Exw, Xoc^Exw, Xoc^Qhh, Xoc, Xoc, Xoc, Xoc, Xoc, Xoc, Iwr, Xoc, Xom, Xoc, Xoc, Xom, Xoc, Xoc, Xom, Xoc, Xom
Xoc, Xoc, Xoc, Xoc, Xoc, Xoc, Xoc, Xoc, Xoc, Xoc, Xoc, Xoc, Xoc^Qhh, Xoc, Xoc^Exw, Ch, Kf, Ch, Xoc^Qhh, Xoc^Qhh, Xoc, Xoc, Xoc, Xoc, Xoc, Xoc, Iwr, Xoc, Xom, Xoc, Xoc, Xom, Xom, Xom, Xom, Xom, Xom
Xoc, Xoc, Xoc, Xoc, Iwr, Xoc, Xoc, Xoc, Xoc, Xoc, Xoc, Xoc, Xoc^Qhh, Xoc^Qhh, Ch, Ch^Efs, Ch, Ch^Efs, Ch, Xoc^Qhh, Xoc^Qhh, Xoc, Xoc, Xoc, Xoc, Iwr, Iwr, Xoc, Xom, Xoc, Xoc, Xom, Xom, Xoc, Xom, Xom, Xom
Iwr, Xoc, Iwr, Iwr, Iwr, Iwr, Iwr, Iwr, Iwr, Xoc, Xoc, Xoc, Ch^Qhh, Xoc^Qhh, Xoc^Efs, Ch, Isc, Ch, Xoc^Efs, Xoc, Ch^Qhh, Xoc, Xoc, Xoc, Iwr, Iwr, Xoc, Xoc, Xoc, Xom, Xoc, Xom, Xom, Xoc, Xoc, Xoc, Xoc
Iwr, Iwr, Xoc, Xoc, Xoc, Xoc, Xoc, Iwr, Iwr^_s, Xoc, Xoc, Xoc, Ch^Qhh, Ch, Isr, Isc, Isc, Isc, Isr^_mhh, Ch, Ch^Qhh, Xoc, Xoc, Xoc, Iwr^_s, Iwr, Xoc, Xoc, Xoc, Xoc, Xoc, Xoc, Xoc, Xoc, Xoc, Xoc, Xoc
Xoc, Xoc, Xoc, Xoc, Xoc, Xoc, Xoc, Xoc, Xoc, Iwr, Rr^Pr/, Xoc^Efs, Isr^Qhh, Isr, Isc, Isc, Isc^Qhh, Isc, Isc, Isr, Isr^Qhh, Xoc^Efs, Rr^Pr\, Iwr, Xoc, Iwr^_s, Iwr, Xoc, Xoc, Xoc, Xoc, Xoc, Iwr, Xoc, Iwr, Xoc, Iwr
Xoc, Xoc, Xoc, Xoc, Xoc, Xoc, Xoc, Xoc, Xoi, Xoi, Isr, Isr, Isr, Isr^Qhh, Isr^Qhh, Isc^Qhh, Isr, Isc^Qhh, Isr^Qhh, Isr^Qhh, Isr, Isr, Isr^_mh, Xoi, Xoi, Xoc, Iwr, Iwr, Iwr, Xoc, Iwr, Iwr, Xoc, Iwr, Iwr, Iwr, Iwr
Xoc, Xoc, Xoc, Xoc, Xoi, Xoc, Xoi, Xoi, Rr^Pr\, Isr, Isr^Ebn, Isr, Isr, Xoc^Efs, Isr, Isr, Isr, Isr, Isr, Xoc^Efs, Isr, Isr, Isr^Ebn, Isr, Rr^Pr/, Xoi, Xoi, Iwr, Xoc, Iwr, Xoc, Xoc, Xoc, Xoc, Xoc, Iwr, Xoc
Xoc, Xoc, Xoi, Xoc, Xoi, Xoi, Iwr^_s, Iwr, Xoc, Xoc, Xoc, Isr, Isr, Wwt, Isr, Isr, Isr, Isr, Isr, Wwt, Isr, Isr, Xoc, Xoc, Xoc, Iwr, Iwr^_s, Xoc, Xoc, Xoc, Xoc, Xoc, Xoc, Xoc, Xoc, Xoc, Xoc
Xoi, Xoi, Iwr, Xoi, Xoi, Iwr, Iwr, Xoc, Xoc, Xoc, Wwt, Wwt, Isr, Wwt, Isr, Isr, Isr, Isr, Isr, Wwt, Isr, Wwt, Wwt, Xoc, Xoc, Iwr^_s, Iwr, Xoc, Iwr, Xoc, Xoc, Xoc, Xoc, Xoc, Xoc, Xoc, Xoc
Xoi, Iwr, Iwr, Iwr, Iwr, Iwr, Xoc, Xoc, Wwt^_s, Wwt, Xoc, Wwt, Wwt, Xoc^Efs, Isr, Isr, Isr, Isr, Isr, Xoc^Efs, Wwt, Wwt, Xoc, Wwt, Wwt^_s, Xoc, Xoc, Iwr, Iwr, Iwr, Iwr, Xoc, Xoc, Xoc, Xoc, Xoc, Xoc
Iwr, Iwr, Iwr, Iwr, Xoi, Iwr, Xoc, Xoc, Wwt, Xoc, Xoc, Isr^Ebn, Isr, Isr, Isr^Qhh, Isr, Isr^Qhh, Isr, Isr^Qhh, Isr, Isr, Isr^Ebn, Xoc, Xoc, Wwt, Xoc, Xoc, Iwr, Xoc, Iwr, Iwr, Xoc, Xoc, Xoc, Xoc, Xoc, Xoc
Iwr, Iwr, Xoi, Xoi, Xoc, Xoc, Xoc, Xoc, Wwt, Xoc, Xoc^Qhh, Xoc, Xoc^Qhh, Isr^Qhh, Xoc^Efs, Isr^Qhh, Iwc, Isr^Qhh, Xoc^Efs, Isr^Qhh, Xoc^Qhh, Xoc, Xoc^Qhh, Xoc, Wwt^Qhh, Xos^Qhh, Xos^Qhh, Xoa^Qhh, Xoa^Qhh, Xoc, Iwr, Xoc, Xoc, Xoc, Xoc, Xoc, Xoc
Xoi, Xoi, Xoc, Xoc, Xoc^Qhh, Xoc, Wwt, Wwt, Xoc^Qhh, Xoc^Qhh, Xoc^Qhh, Xoc^Qhh, Xoc, Xoc, Ch, Iwc, Iwc, Iwc, Ch, Xoc, Xoc, Xoc^Qhh, Xoa, Xoa^Qhh, Sm, Wwt, Wwt, Xoa^Qhh, Xoa^Qhh, Xoc^Qhh, Iwr^Qhh, Iwr, Xoc, Xoc, Xoc, Xoc, Xoc
Xoc^Qhh, Xoc^Qhh, Xoc^Qhh, Xoc^Qhh, Xoc^Qhh, Wwt^Qhh, Xoc^Qhh, Xoc^Qhh, Xoc^Qhh, Xoc^Qhh, Xoc^Qhh, Xoc, Xoc, Xoc, Xoc, Iwc, Iwc, Iwc, Xoc, Xoc, Xoc, Xoa, Sm, Sm, Sm, Sm, Sm, Wwt, Xoa, Xoc^Qhh, Xoc, Iwr^Qhh, Iwr^Qhh, Iwr^Qhh, Iwr^Qhh, Xoc^Qhh, Xoc^Qhh
Xoc^Qhh, Xoc^Qhh, Xoc, Xoc^Qhh, Xoc, Wwt, Xoc, Xoc, Xoc^Qhh, Xoc^Qhh, Xoc, Xoc, Xoc, Xoc, Xoc^Efs, Iwc, Iwc, Iwc, Xoc^Efs, Xoc, Xoc, Xoa, Sm, Sm, Xuc, Uu, Xoa, Wwt, Xoc, Xoc, Iwr, Iwr, Iwr, Iwr, Iwr, Iwr, Iwr
Xoc, Xoc, Xoc, Xoc, Xoc, Wwt, Xoc, Xoc, Xoc, Xoc, Xoc, Xoc, Xoc, Xoc, Ch, Iwc, Iwc, Iwc, Ch, Xoc, Xoc, Xoa, Xoa, Sm, Uu, Uu, Xoa, Wwt, Iwr, Iwr, Xoc, Iwr, Gll^Feth, Iwr, Iwr^Dr, Iwr, Iwr
Xoc, Xoc, Xoc, Xoc, Xoc, Wwt, Xoc, Xoc, Xoc, Xoc, Xoc, Xoc, Xoc, Xoc, Xoc, Iwc, Iwc, Iwc, Xoc, Xoc, Xoc, Xoc, Xoc, Xoc, Xoc, Xoa, Xoc, Wwt, Xoc, Xoc, Xoc, Iwr, Xoc, Iwr, Iwr, Iwr, Iwr
Wo, Xoc, Wo, Xoc, Wo, Wwt, Wo, Xoc, Xoc, Xoc, Xoc, Xoc, Xoc, Xoc, Xoc, Iwc, Iwc, Iwc, Xoc, Xoc, Xoc, Xoc, Xoc, Xoc, Xoc, Xoc, Gs^Ft, Wwt, Gs^Ft, Xoc, Gs^Ft, Xoc, Gg, Xoc, Gg^Dr, Iwr, Gg
Wo, Wo, Xuf, Wo, Ww^Ewf, Gg^Ecf, Wo, Xoc, Xoc, Xoc, Xoc, Xoc, Xoc, Xoc, Ch, Iwc, Iwc, Iwc, Ch, Xoc, Xoc, Xoc, Xoc, Xoc, Gs^Ft, Gs^Ft, Gs^Ft, Gs^Ft, Xuf, Gs^Ft, Gs^Ft, Gs^Ft, Gg, Gg, Gg, Gg^Dr, Gg
Wo, Wo, Gg, Gg, Gll^Feth, Wo, Wo, Xoc, Xoc, Xoc, Xoc, Xoc, Xoc, Xoc, Xoc, Iwc, Iwc, Iwc, Xoc, Xoc, Xoc, Xoc, Xoc, Xoc, Gs^Ft, Gg^Fet, Gs^Ft, Gs^Ft, Gs^Ft, Gs^Ft, Gs^Ft, Gg^Wm, Gg, Xuf, Gg, Gg, Gg
Gg, Gg, Gg, Gg, Xoc, Xoc, Xoc, Xoc, Xoc, Xoc, Xoc, Xoc, Xoc, Xoc, Xoc, Iwc, Iwc, Iwc, Xoc, Xoc, Xoc, Xoc, Xoc, Xoc, Gs^Ft, Gs^Ft, Gs^Ft, Gs^Ft, Gs^Ft, Gs^Ft, Gs^Ft, Gg, Gg, Gg, Gg, Gg, Gg
