Mm, Ms^Xm, Mm, Mm^Xm, Mm, Mm, Mm, Mm, Mm, Mm, Mm, Mm, Mm, Mm, Mm, Mm, Mm, Mm, Mm, Mm, Mm, Mm, Mm^Xm, Mm^Xm, Mm^Xm, Mm^Xm, Mm^Xm, Mm^Xm, Mm, Mm, Mm, Mm, Mm^Xm, Mm, Mm^Xm, Mm, Mm, Mm, Mm, Mm, Mm, Mm, Mm, Mm, Hh, Hh, Ss^Qhux, Ss^Qhux, Gll^Fdw, Gll^Fp
Ms^Xm, Ms^Xm, Mm, Mm^Xm, Mm^Xm, Mm^Xm, Mm^Xm, Mm, Mm, Mm, Mm, Mm, Mm, Mm, Mm, Mm, Mm, Mm, Mm, Mm, Mm, Mm, Mm, Mm^Xm, Mm^Xm, Mm^Xm, Mm^Xm, Mm^Xm, Mm, Mm, Mm, Mm^Xm, Mm^Xm, Mm^Xm, Mm^Xm, Mm, Mm, Mm, Mm, Mm, Hh, Mm, Hh, Hh, Hh, Hh, Ss^Qhux, Gll^Fdw, Gll^Fdw, Gll^Fdw
Ms^Xm, Ms^Xm, Ms^Xm, Ms^Xm, Mm^Xm, Ms^Xm, Ms^Xm, Mm^Xm, Ms^Xm, Mm^Xm, Mm^Xm, Mm^Xm, Mm, Mm, Mm, Mm, Mm, Mm, Mm, Mm, Mm, Hh, Mm, Mm, Mm^Xm, Mm, Mm^Xm, Mm^Xm, Mm, Mm, Mm, Mm, Mm, Mm^Xm, Mm^Xm, Mm, Hh, Mm, Hh, Hh, Hh, Hh, Hh, Hh, Sm, Ss^Qhux, Gll^Fdw, Gll^Fdw, Re, Ss^Fdw
Ms^Xm, Ms^Xm, Ms^Xm, Mm^Xm, Mm^Xm, Mm, Mm^Xm, Ms^Xm, Ms^Xm, Mm^Xm, Ms^Xm, Mm, Mm, Mm, Mm, Mm, Ce, Mm, Ce, Re^Vct, Hh, Mm, Mm, Mm^Xm, Mm^Xm, Mm^Xm, Mm^Xm, Mm, Hh, Hh, Hh, Mm, Hh, Mm, Mm, Hh, Hh, Hh, Hh, Hh, Gd^Fdw, Hh, Sm, Sm, Chs, Gll^Fdw, Re^Edb, Re, Ss, Ss
Ms^Xm, Ms^Xm, Ms^Xm, Mm^Xm, Mm^Xm, Mm^Xm, Mm, Mm^Xm, Mm^Xm, Ms^Xm, Ms^Xm, Ms^Xm, Re, Mm, Mm, Mm, Ce, Ke, Ce, Hh, Hh, Hh, Mm^Xm, Mm^Xm, Mm, Mm, Mm, Mm, Hhd, Hh, Hh, Hh, Hh, Hh, Hh, Hh, Gll, Gll^Fdw, Gll^Fmw, Gd^Fmw, Gd^Fmw, Gd^Fdw, Sm^Bw/r, Sm^Bw/r, Ss, Re^Edb, Gll^Fdw, Gll^Fdw, Gll^Fdw, Gll^Fdw
Mm, Mm^Xm, Mm^Xm, Mm, Mm, Mm, Mm, Mm, Mm, Ms^Xm, Mm^Xm, Mm, Mm, Re, Re, Mm, Ce, Ce, Hh, Hh, Hh, Re^Vct, Ce, Ww, Ww, Mm, Mm, Mm, Gll^Fdw, Gll^Fdw, Sm^Qhux, Hh, Sm^Qhux, Sm^Qhux, Ss, Ss, Rp, Gll^Fmw, Gll^Fdw, Gd^Fmw, Rp, Rp, Sm, Sm, Gll^Fdw, Gll^Fdw, Gll^Fdw, Ss, Ss, Ss
Mm^Xm, Mm^Xm, Mm, Mm^Xm, Mm, Mm, Mm, Mm, Mm^Xm, Mm^Xm, Mm^Xm, Mm, Mm, Mm, Re, Hh, Hh, Hh, Re, Hh, Re, Re, Ce, Ss, Gll^Fmw, Gll^Vhr, Mm, Mm, Ss, Gll^Fdw, Sm^Qhux, Sm^Qhux, Ss, Ss, Ss, Gll^Fp, Rp, Gll^Fdw, Rp, Rp, Gll^Edt, Gll, Sm, Sm, Ss, Ss, Ss, Ss, Ss, Ss
Mm, Mm^Xm, Mm^Xm, Mm^Xm, Mm, Mm, Mm, Mm^Xm, Mm^Xm, Mm^Xm, Mm^Xm, Mm^Xm, Mm^Xm, Hh, Re^Vct, Re, Re, Re, Ce, Re, Gll, Ce, Ss, Ss, Gll^Fmw, Gll^Fmw, Gll^Fmw, Gll^Fmw, Ss, Ss, Ss, Ss, Wwrg, Wwg, Wwg, Gll^Vl, Gll^Fdw, Rp, Rp^Edt, Gll^Edt, Gll^Edt, Gll, Sm, Sm, Sm, Ss, Gll^Fdw, Ss, Ss, Ss
Mm^Xm, Mm, Mm^Xm, Mm, Mm, Mm, Mm, Mm^Xm, Mm, Mm, Mm, Mm^Xm, Mm^Xm, Ce, Ce, Hh, Re, Ce, Gs^Edt, Gll^Es, Gd^Efm, Ss, Ss, Ss, Ss, Gll^Fdw, Gll^Fdw, Ss, Wwf, Ss, Wwrg, Wwrg, Wwrg, Wwrg, Wwrg, Ss, Gll^Edt, Gd^Edt, Gll^Edt, Rp^Edt, Rp, Gll, Gd^Edb, Sm, Sm, Sm, Gll^Fdw, Ss, Ss, Ss
Mm^Xm, Mm^Xm, Mm^Xm, Mm^Xm, Mm, Mm, Mm, Mm, Hh, Mm, Hh, Hh, Hh, Hh, Hh, Hh, Ww^Bw|r, Ss, Gll, Gd, Gd^Efm, Gll^Efm, Wwrg, Wwg, Wwg, Ss, Wwg, Wwf, Wwf, Wwf, Wwf, Wwg, Gll^Fdw, Wwg, Ss, Ss, Sm, Gd^Edt, Gll^Edt, Gll^Edt, Rp, Gd^Edb, Gd^Edb, Gd^Wm, Sm, Sm, Sm, Gll^Fdw, Ss, Ss
Mm^Xm, Mm, Mm^Xm, Mm^Xm, Mm, Mm, Mm, Hh, Hh, Hh, Hh, Hh, Ss, Hh, Ss, Ss, Rb, Ss, Wwf, Wwf, Wwg, Wwg, Wwrg, Wwrg, Wwg, Wwg, Ss, Wwf, Ss, Wwf, Wwf, Hh, Hhd, Hh, Hh, Ss, Sm, Sm, Sm, Chr, Rp, Gll^Edb, Gs^Vl, Ss, Sm, Ss, Ss, Sm, Ss, Ss
Mm^Xm, Mm^Xm, Mm^Xm, Mm, Mm, Mm, Mm, Hh, Hh, Hh, Gll^Es, Gll, Ss, Ss, Gll, Rb, Gll, Sm, Wwf, Wwf, Wwf, Wwg, Wwrg, Wwrg, Wwrg, Wwg, Ss, Hh, Ss, Hh, Hh, Hh, Hhd, Hh, Hh, Hh, Chs^Dr, Sm, Sm^Bsb/, Sm^Bsb/, Sm, Gll, Ss, Ss, Sm, Ss, Ss, Sm, Sm, Sm
Mm^Xm, Mm^Xm, Mm, Mm, Mm, Mm, Hhd^Vhhr, Hh, Hhd, Hh, Hh, Gll, Ss, Gll, Gll^Edt, Re, Ss^Vhs, Sm, Sm, Wwf, Wwf, Wwf, Wwf, Wwrg, Ss, Wwg, Hh, Hh, Mm^Xm, Mm^Xm, Mm^Xm, Mm, Hhd, Mm, Rp^Vhcr, Hh, Rp, Re^Bsb/, Sm, Sm, Sm, Ss, Ss, Gll^Fdw, Sm, Ss, Wog, Sm, Wog, Sm
Mm^Xm, Mm^Xm, Mm, Mm, Mm, Mm, Mm, Hh, Hhd, Hhd, Hh, Ss, Ss, Gll, Re^Edt, Re^Edt, Ss, Sm, Sm, Sm, Sm, Wwf, Rb, Chs, Ss, Hh, Mm^Xm, Mm^Xm, Mm^Xm, Mm^Xm, Hh, Hhd, Rb^Edt, Rb^Edt, Rp, Rp, Rb, Chs, Sm, Sm, Ss, Ss, Gll^Fdw, Gll^Fdw, Ss, Sm, Sm, Wog, Wog, Wog
Mm^Xm, Mm^Xm, Mm^Xm, Mm, Mm, Mm, Mm, Hh, Hh, Hhd, Hh, Hh, Ss, Re, Gll^Edt, Gll^Edt, Gll^Edt, Sm, Sm, Wwrg, Sm, Mm, Mm, Rb, Gll, Hh, Mm^Xm, Mm^Xm, Mm^Xm, Hh, Hh, Gd^Edt, Gll^Edt, Rp, Rp^Vhcr, Rb, Gll, Rb, Hh, Ss, Hh, Ss, Ss, Ss, Ss, Sm, Sm, Wog, Wog, Wog
Mm^Xm, Mm^Xm, Ms^Xm, Mm^Xm, Mm, Mm, Mm, Hh, Mm, Hh, Hh, Hh, Gll^Efm, Re, Re^Efm, Gll^Edt, Gll^Edt, Ww, Sm, Sm, Wwrg, Mm, Mm, Rb, Rb, Mm, Mm^Xm, Mm^Xm, Hh, Hh, Rb, Gll, Rp, Rp, Rp^Edb, Gll, Rb, Gd, Hh, Mm, Mm^Xm, Mm^Xm, Hh, Ss, Ss, Gll^Vl, Sm, Wog, Wog, Wog
Ms^Xm, Ms^Xm, Ms^Xm, Mm^Xm, Mm^Xm, Mm, Mm^Xm, Mm, Mm, Mm, Mm, Hh, Hh, Gll^Efm, Gll, Re, Ww, Wwrg, Ww, Wog, Wog, Ss, Ss, Mm, Mm, Rb, Rb, Hh, Hh, Rp^Vhcr, Rp, Rp, Chr^Edb, Chr^Edb, Chr^Edb, Rp, Rp, Rp^Vhcr, Mm, Mm^Xm, Mm^Xm, Mm^Xm, Mm, Hh, Re, Re, Sm, Sm, Sm, Wog
Ms^Xm, Ms^Xm, Mm^Xm, Mm^Xm, Mm^Xm, Mm^Xm, Mm, Mm, Mm, Mm, Mm, Mm, Mm, Hh, Gs^Vhr, Re, Gll, Gll, Wwrg, Wwrg, Wog, Wog, Wwrg, Ss, Mm, Mm, Re, Rb, Rp, Rb^Ecf, Rp, Rp, Chr^Edb, Kh^Edb, Chr^Edb, Rp^Edb, Rb, Hh, Mm, Mm^Xm, Mm^Xm, Mm, Mm, Mm, Re, Sm, Ss, Sm, Ss, Sm
Mm^Xm, Mm^Xm, Mm^Xm, Mm^Xm, Mm^Xm, Mm^Xm, Mm, Mm, Mm, Mm, Mm, Mm, Hh, Hh, Gll, Re, Gll, Gll^Dr, Gll^Es, Ss, Ss, Wog, Wog, Ss, Chs, Mm, Rp, Rp, Gll, Rp, Gll, Rp, Rp, Chr^Edb, Rp^Edb, Rp^Edb, Rb, Rb, Mm, Mm, Mm^Xm, Mm^Xm, Mm, Mm, Gll, Re, Re, Ss, Ss, Gg
Mm^Xm, Mm^Xm, Mm^Xm, Mm^Xm, Mm, Mm, Hh, Mm, Hh, Hh, Hh, Hh, Hh, Ss^Qhux, Gll, Re, Gll, Gll, Gd, Ss, Ss, Ss, Wwg, Wwg, Wwg^Bsb/, Rp, Rb, Rp^Vhcr, Rb, Gll, Iwo^Edb, Rb, Rp, Rp, Rb, Rp^Edb, Rb, Hh, Mm, Mm^Xm, Mm^Xm, Mm^Xm, Mm, Mm, Gll^Vl, Re, Re, Gll, Ss, Gg
Mm^Xm, Mm^Xm, Mm, Mm, Mm, Hh, Hh, Hh, Hh, Hh, Gll, Hh, Gll^Fdw, Gll^Fdw, Gll^Efm, Re, Gll^Edt, Gd^Edt, Gll^Edt, Gll, Gll, Ss, Wwg^Bsb/, Ss^Bsb/, Sm, Chs, Rb, Rb, Ss^Bw/r, Iwr, Ss, Iwo, Iwr, Rb, Rb^Edt, Rp, Rp^Vhcr, Hh, Mm^Xm, Mm^Xm, Mm^Xm, Mm^Xm, Mm, Hh, Gll, Re, Re, Gll^Vl, Ss, Ss
Mm, Mm, Mm, Mm, Mm, Mm, Hh, Hh, Gll, Gll, Ww, Ww, Gll, Gll^Efm, Gll^Efm, Re^Edt, Rp^Edt, Rp^Edt, Rp, Gll, Rp, Rp, Ss, Wwg, Wwg, Sm, Ss, Ss^Bw/r, Ss, Ss, Ss^Bw/r, Ss^Bw/r, Ss, Iwo^Edt, Gd^Edt, Gd^Edt, Hh, Mm, Mm, Mm^Xm, Mm, Mm, Mm, Mm, Hh, Gll, Re, Ss, Ss, Ss
Mm, Mm, Mm, Mm, Mm, Hh, Hh, Gll, Gll, Gll^Es, Ww, Gll, Gll, Gll^Efm, Re, Re, Gll, Gll^Edt, Gll^Edt, Rp^Edt, Rp, Gll, Ss, Wwg, Wwg, Wwg, Wwg, Ss, Ss, Ss, Ss, Ss, Ss^Bw/r, Iwo^Edt, Rb, Hh, Hh, Hh, Mm, Mm, Mm, Mm, Mm, Hh, Gll, Re, Ss, Ss, Ss, Ss
Mm, Mm, Mm, Mm, Mm, Mm, Mm, Hh, Hh, Gll, Ww, Ww, Ss, Ss, Re, Gll, Ss, Gll, Gd, Gll^Edt, Rp, Gll, Gll, Ss, Ss, Wog, Wog, Wwg, Wwg, Sm, Sm, Ss^Bw/r, Ss, Hh, Hh, Hh, Mm, Mm, Hh, Hh, Hhd, Hh, Hhd, Hhd, Gll, Re, Ss, Ss, Ss, Ss
Mm, Mm, Mm, Mm, Hhd^Vhhr, Mm, Hh^Edt, Hh, Re^Edt, Gll, Ww^Bw/r, Chw, Chw, Re, Ss, Ss, Ss, Ss, Gd, Gd, Gll, Rp, Re, Ss, Ss, Ss, Wwg, Wog, Wwg, Wwg, Ss, Ss, Ss, Hh, Hh, Hh, Hh, Hh, Hh, Hhd, Hh, Hh, Hh, Hhd, Gll^Efm, Re^Es, Gll, Ss, Ss, Ss
Mm, Mm, Hhd, Hhd, Hh, Hh, Re^Edt, Re^Edt, Cer^Edt, Re, Ss^Vhs, Ww, Ww, Ww, Ww, Ss, Gll^Fp, Ss, Ss, Ss, Ss, Ss, Gll, Re, Re, Ss, Ss, Wwg, Wwg, Wwg, Wwg, Ss, Wwg, Wwg, Hh, Mm, Hh, Hh, Gll, Gll, Hh, Hh, Gll, Gll^Efm, Gll^Efm, Re, Sm, Ss, Ss, Gll
Mm, Mm, Hhd, Hhd, Hh, Ker^Edt, Cer^Edt, Cer^Edt, Cer^Edt, Ss, Ww, Ww, Wo, Wo, Ww, Ww, Gll^Fdw, Gll^Fdw, Gll^Fdw, Gll^Fdw, Ss, Ss, Ss, Ss^Vhs, Ww^Bw|r, Gll, Gll, Ss, Wwg, Wwg, Wog, Wwg, Wwg, Wwg, Wwg, Hh, Hh, Hh, Ss, Ss, Hhd, Hh, Hhd, Ss, Re, Re, Sm, Gll, Gd, Gd
Mm, Mm, Hh, Hh, Gll^Fdw, Ss, Gll^Ecf, Cer^Edt, Ss, Ww, Ww, Ww, Wo, Wo, Ww, Ww, Ss, Gll^Fdw, Gll^Vhr, Gll^Fdw, Gll^Fmw, Gll^Fdw, Ss, Ss, Re, Ss, Ss, Ss, Wwg, Wwg, Wwg, Wog, Wog, Wwg, Wog, Wwg, Wwg, Gll, Ss, Ss, Hhd, Hhd, Ss, Ss, Ss, Sm^Bw\, Re, Sm, Sm, Gd
Mm, Hh, Gll^Fdw, Hh, Gll^Fdw, Ss, Ss, Gll, Ss^Vhs, Ww, Ww, Ww, Wo, Wo, Ww, Ww, Ww, Gll^Fmw, Gll^Fmw, Gll^Fmw, Gll^Fmw, Gll^Fdw, Ss, Ss, Re, Gll, Ss, Ss, Ss, Wwg, Wog, Wog, Wog, Wog, Wog, Wog, Wwg, Wwg, Wog, Ss, Ss^Vhs, Ss, Ss, Ss, Ss, Sm, Sm, Re, Gll, Sm
Mm, Gll^Fdw, Gll^Fdw, Gll^Fdw, Hh, Gll^Fdw, Ss, Ww, Ww, Ww, Ww, Ww, Wo, Wo, Ww, Ww, Sm, Sm, Gll^Fmw, Gll^Fmw, Gll^Fmw, Gll^Fmw, Ss, Ss, Gll, Re, Ss, Gll^Fdw, Ss, Ss, Ss, Wog, Wwg, Wog, Wwg, Wwg, Wwg, Wwg, Wog, Wog, Wog, Ss, Wwg, Ss, Ss, Sm, Wwf, Gd^Vhr, Gll^Efm, Gll
Mm, Mm, Mm, Hh, Hh, Hh, Ss, Ww, Ww, Ww, Ww, Wo, Wo, Ww, Ww, Sm, Sm, Sm, Gd^Fmw, Gd^Fmw, Gll^Fmw, Gll^Fmw, Ss, Ss, Re, Re, Ss, Gll^Fdw, Gd^Vhr, Ss, Ss, Wwg, Wwg, Wwg, Wwg, Wwg, Wwg, Wwg, Wwg, Wog, Wog, Wog, Wwg, Wwg, Wwf, Wwf, Wwf, Ss, Ss, Gll
Mm^Xm, Mm^Xm, Mm, Mm, Mm, Mm, Hh, Ww, Ww, Ww, Wo, Wo, Ww, Ww, Ww, Sm, Gd, Gd, Ss, Gd^Fmw, Ss, Ss, Ss, Re, Gll^Es, Gll, Ss, Gll^Fdw, Gll^Fdw, Ww, Ww, Ss, Sm, Ss, Ss, Ss, Ss, Sm, Sm, Wwg, Wwg, Wog, Wwg, Wwg, Wwf, Wwf, Ss, Ss, Ss, Ss
Mm^Xm, Mm^Xm, Mm^Xm, Mm, Hh, Hh, Ss, Ww, Ww, Ww, Wo, Ww, Ww, Ww, Sm, Sm, Ss, Ss, Ss, Ss, Ss, Gll, Re, Re, Sm^Qhux, Sm^Qhux, Sm^Qhux, Gll^Fdw, Gll^Fdw, Gll^Fdw, Ss, Ss, Sm, Gll, Gll, Gll, Ss, Sm, Ss, Sm, Ss, Wwg, Wwg, Wwf, Wwf, Wwg, Wwg, Wwg, Wwg, Wwg
Mm^Xm, Mm^Xm, Mm, Mm, Hh, Ss, Ss, Gll, Ww, Ww, Ww, Ww, Ww, Sm, Sm, Ss, Ss, Ss, Ss, Ss, Ss, Gll, Re, Ss, Sm^Qhux, Sm^Qhux, Sm^Qhux, Sm^Qhux, Ss, Ww, Ss, Sm, Sm, Sm, Gd, Gll^Dr, Gll, Gll, Ss, Ss, Ss, Ss, Wwf, Wwf, Wwg, Wwg, Wog, Wog, Wog, Wwg
Mm, Mm^Xm, Mm, Hh, Ss, Ss, Ss, Ss, Ss, Gll, Ww, Gd^Vhr, Gd, Gll, Ss, Gd^Fdw, Ss, Ss, Ss, Ss, Ss, Ss^Vhs, Re, Ss, Ss, Sm^Qhux, Sm^Qhux, Sm^Qhux, Ss, Ss, Ss, Sm, Sm, Gd, Gd^Efm, Gll^Efm, Gll^Efm, Ss, Ss, Gd, Gll, Gll^Fmw, Gll^Fmw, Wwf, Wwg, Wwg, Wog, Wog, Wog, Wog
Mm, Mm, Mm, Hh, Ss, Ss, Gll^Fdw, Ss, Ss, Gll, Gll, Gll^Es, Gd, Gd, Ss, Ss, Ss, Ss, Ss, Ss, Ss, Ss, Ww^Bw|r, Ss, Ss, Sm^Qhux, Gll^Fdw, Ss, Ss, Ss, Ss, Gll, Ss, Ss, Ss, Gll^Efm, Gll, Ss, Ss, Gd, Gll, Gll^Fmw, Ss, Ss, Ss, Wwg, Wwg, Wog, Wog, Wog
Mm, Mm, Mm, Hh, Hh, Ss, Hh, Gll^Fdw, Ss, Ss, Ss, Gll, Gll, Gll, Ss, Ss, Ss, Ss, Ss, Ss, Ss, Ss, Re, Ss, Gll^Fdw, Gll^Fdw, Gll^Fdw, Ss, Ss, Ss, Ss, Ss, Ss, Ss, Ss, Ss, Ss^Vhs, Ss, Ss, Gll^Ecf, Ker^Edt, Gll^Edt, Gll^Edt, Ss, Ss, Ss, Ss, Wwg, Wog, Wog
Mm, Mm, Hh, Hh, Hh, Hh, Gll^Fdw, Gll^Fdw, Ss, Ss, Ss, Ss, Gll, Ss, Ss, Ss, Ss, Hh, Hh, Ss, Ss, Gll, Re, Ww, Ww, Gll^Fdw, Ww, Gll^Fdw, Ss^Vhs, Ss, Ss, Ss, Gll, Ss, Ss, Ss, Ss, Ss, Ss, Ss^Edt, Cer^Edt, Ss, Ss^Edt, Ss, Ss, Ss, Ss, Ss, Ss, Wwg
Hh, Hh, Hh, Ss^Qhux, Ss^Qhux, Ss^Qhux, Gll^Fdw, Gll^Fdw, Ss, Ss, Ss^Vhs, Hh, Ss, Ss, Mm, Hh, Mm, Mm, Mm, Ss, Ss, Gll, Re, Ww, Ww, Ww, Sm, Ss, Ss, Ss, Ss, Ss, Gll, Ss, Ss, Ss, Ss, Ss, Ss, Cer^Edt, Cer^Edt, Cer^Edt, Ss^Edt, Gll^Fdw, Gll^Fdw, Gll^Fdw, Ss, Ss, Hh, Ss
Hh, Hh, Ss^Qhux, Ss^Qhux, Ss^Qhux, Ss^Qhux, Gll^Fdw, Gll^Fdw, Gll^Fdw, Gll^Fdw, Ss, Hh, Hhd, Hhd, Mm, Mm, Mm^Xm, Mm^Xm, Mm, Ss, Ss, Re, Ss, Ww, Ww, Ww, Sm, Ss, Ss, Ss, Gll^Efm, Gll, Gll^Es, Ss, Ss, Ss, Ss, Ss, Gll, Cer^Edt, Gll^Fdw, Cer^Edt, Ss, Gll^Fdw, Gll^Fdw, Ss, Ss, Ss, Gll, Hh
Hh, Hh, Ss^Qhux, Ss^Qhux, Ss^Qhux, Ss^Qhux, Gll^Fdw, Gll^Fdw, Gll^Fdw, Gll^Fdw, Ss, Ss, Hhd, Ss, Ss, Mm, Mm, Mm^Xm, Mm, Ss, Ww^Bw/r, Chs, Ss, Ww, Ww, Ww, Sm, Sm, Ss, Ss, Gll^Efm, Gll^Efm, Sm, Gll, Ss, Ss, Ss, Gll, Gd^Vhr, Gll^Fdw, Gll^Fdw, Gll^Fdw, Sm, Sm, Sm, Sm, Sm, Sm, Sm, Hh
Hhd, Hhd, Gll, Gll^Efm, Gll^Efm, Ww^Qhux, Ww^Qhux, Ww^Qhux, Gll^Fdw, Gll^Fdw, Gll^Fdw, Ss, Ss, Ss, Ss, Ss, Hh, Mm^Xm, Hh, Re, Ss, Ss, Ss, Ss^Vhs, Ww, Sm, Sm, Sm, Sm, Sm, Sm, Sm, Sm, Gll, Gll^Efm, Ss, Gll, Gd, Gd, Ww, Ww, Ww, Ww, Sm, Sm, Sm, Sm, Sm, Ww, Ww
Hhd, Hh, Gll, Gd^Efm, Gll^Efm, Gll^Efm, Ww^Qhux, Ww^Qhux, Gll^Fmw, Gll^Fdw, Gll^Fmw, Gll^Fdw, Ss, Ss, Ss, Ss, Gll, Gll, Gll^Vh, Re, Gll, Ss, Ss, Gll, Ss, Sm, Ss, Ss, Ss, Ss, Gll, Sm, Sm, Sm, Gll^Efm, Gll^Efm, Ss, Gll, Ww, Ww, Ww, Ww, Ww, Gll^Efm, Gll^Efm, Gll^Efm, Ww, Ww, Ww, Ww
Hh, Hh, Gll, Gd, Ss^Qhux, Ww^Qhux, Gll^Fmw, Gll^Fmw, Gll^Fmw, Gll^Fmw, Gll^Fmw, Ss, Ss, Ss, Gll^Efm, Gll^Efm, Gll^Efm, Gll^Es, Gd, Re, Gd, Gd, Gd, Gll, Gd, Sm, Ss, Ss, Ss, Ss, Gll, Gll, Sm, Sm, Ss, Ss, Ss, Ss, Gll, Gll^Fdw, Gll^Fdw, Gll^Fdw, Gll, Gll^Efm, Gll, Gll, Ss, Ww, Ww, Ww
Ss^Qhux, Ss^Qhux, Ss^Qhux, Gll^Es, Ss^Qhux, Gll^Fp, Gll^Fmw, Gll^Fmw, Gll^Fmw, Ww, Ss, Ss, Ss, Ss, Ss, Gll^Efm, Gll^Efm, Gd^Efm, Gd^Es, Re, Gd, Gll, Gll, Gd, Gd, Ss, Ss, Ss, Gll^Fmw, Ss, Gll, Gll, Hh, Hh, Ss, Ss, Ss, Ss, Ss, Ss, Gll, Gll, Gll, Gll, Gll, Gll, Gd, Gll, Sm, Sm
Ss^Qhux, Ss^Qhux, Hh, Ss^Qhux, Ss^Qhux, Ss^Qhux, Gll^Fmw, Gll^Fmw, Gll^Fmw, Gll^Fmw, Ss, Ww, Ss, Ss, Ss, Ss, Ss, Ss, Gd, Re, Gll, Gd, Re, Gd, Gd^Es, Ss, Ss, Gll^Fmw, Ss, Ss^Vhs, Ss, Hh, Mm^Xm, Hh, Hhd, Ss, Ss, Ss, Ss, Ss, Gll, Gll, Ss, Ss, Ss, Gd, Gd^Es, Sm, Sm, Sm
Hh, Hh, Hh, Hh, Ss, Ss^Fmw, Ss^Fmw, Gll^Fmw, Gll^Fmw, Gll^Fmw, Ww, Ww, Ww, Ss, Ww, Ww, Ww, Ss, Gll, Re, Re, Re, Gd, Re, Re, Ss, Ss, Ss, Ss, Ss, Hh, Hh, Mm^Xm, Mm^Xm, Mm^Xm, Hhd, Hhd, Ss, Ss, Ss, Ss, Gll, Ss, Ss, Ss, Gd, Sm, Sm, Sm, Sm
