Xos, Xos, Xos, Xos, Xoi, Xoi, Urc, Xoi, Xuc, Xuc, Xoi, Xos, Xos, Xos, Xos, Xos, Xos, Xos, Xos, Xos, Xos, Xos, Xos, Xos, Xoc, Xoc, Xoc
Xos, Xos, Xoi, Xoi, Urc, Xoi, Xom, Iwo, Iwo, Xot, Xoi, Xoi, Xoc, Xoc, Xoc, Xos, Xos, Xos, Xos, Xos, Xue, Xue, Xue, Xue, Xoi, Xu, Xu
Xoi, Xoi, Urc, Xoi, Xom, Iwo, Iwo, Iwo, Xoi, Iwo, Urc, Xoi, Isr, Isr^Ebn, Isr, Xos, Xos, Xos, Xos, Xue, Xue, Xue, Xue, Xue, Xu, Xu, Qxua
Urc, Xoi, Xoi^Efs, Iwo, Iwo, Iwo, Xoi, Iwo, Urc, Xoi, Xoi, Xoc, Isr^Ebn, Urb^Ii, Isr^Ebn, Xos, Xos, Xos, Xos, Xue, Xue, Xue, Xue, Xue, Xu, Xu, Qxua
Xoi, Iwo, Iwo, Iwo, Xom, Iwo, Urc, Xoi, Xoi, Xoi, Xoi, Xos, Xoc, Isr, Xoc, Xoc, Xos, Xos, Xos, Xue, Xue, Xue, Xue, Xue, Xu, Xu, Qxua
Iwr, Iwo, Iwo, Iwo, Iwo, Xom, Xom, Xoi, Xoi, Xoi, Xos, Xoi, Xos, Xoc, Xos, Xu, Xos, Xos, Xu, Xu, Xue, Xue, Qxua, Qxua, Iwo, Iwo, Xu
Xoi, Xoi, Iwo, Xoi, Xoi, Iwo, Iwo, Xoi, Xoi, Xoc, Isa^Qhh, Xoc^Efs, Isa^Qhh, Isa^Qhh, Isa^Qhh, Xoc^Efs, Isa^Qhh, Xos, Xos, Xoc, Qxua, Qxua, Qxua, Qxua, Qxua, Xu, Xu
Xoi, Xoi, Urc, Xoi, Xoi, Xoi, Xoi, Rr^Pr/, Isa^Qhh, Isa^Qhh, Isa^Vhc, Isa^Qhh, Isa, Isa, Isa, Isa^Qhh, Isa^Vhc, Isa^Qhh, Isa^Qhh, Qxua, Qxua, Qxua, Qxua, Qxua, Qxua, Qxua, Xu
Xoi, Xoi, Xoi, Xoi, Xoi, Xoi, Isa^Qhh, Isa^Qhh, Isa, Isa, Ww, Isa, Cud, Cud, Cud, Isa, Ww, Isa, Isa^_mhh, Isa^Qhh, Isa^Qhh, Qxua, Qxua, Qxua, Xue, Qxua, Xu
Xoi, Xoi, Xoi, Xoi, Urb, Rr^Pr\o, Xos, Isa^Qhh, Isa^Ebn, Ww, Isa, Isa^Ebn, Cud, Kud, Cud, Isa^Ebn, Isa, Ww, Isa^Ebn, Isa, Isa^Qhh, Qxua, Xos, Xue, Xoi, Xue, Xu
Xoi, Xoi, Xoi, Urb, Xoi, Urb, Xos, Isa^Qhh, Isa, Ww, Isa^Vhc, Isa, Isa, Cud, Isa, Isa, Isa^Vhc, Ww, Isa, Isa, Isa^Qhh, Xos, Xoi, Xoi, Xoi, Xoi, Xu
Xoi, Xoi, Xoi, Urb, Xoi, Urb, Xos, Isa^Qhh, Isa^Qhh, Isa^Qhh, Isa^Qhh, Isa^Qhh, Isa^Qhh, Isa^Qhh, Isa^Qhh, Isa^Qhh, Isa^Qhh, Isa^Qhh, Isa^Qhh, Isa^Qhh, Xos, Xos, Xoi, Xoi, Xoi, Xoi, Xu
Xoi, Xoi, Urb, Urb, Urb, Urb, Xos, Xos, Isa, Isa, Isa, Xos, Xos^Efs, Xos, Xoc^Efs, Xoc, Isa, Isa, Isa, Xos, Xos, Xoc, Xoi, Xoi, Xoi, Xoi, Xu
Xoi, Xoi, Urb, Xoi, Urb, Xoi, Xos, Tb^Tf, Uu, Uu, Uu, Isa, Urb, Uu^Eb, Urb, Isa, Uu, Uu, Uu, Tb^Tf, Xos, Xoi, Xoi, Xoi, Xoi, Xoi, Xu
Xoi, Xoi, Urb, Xoi, Urb, Xoi, Xoi, Tb^Tf, Uu, Wwg, Wwg, Ur, Urb, Uu^Emf, Urb, Ur, Wwg, Wwg, Uu, Tb^Tf, Xos, Xoi, Xoi, Xoi, Xoi, Xoi, Xu
Xoi, Xoi, Xoi, Urb, Xoi, Urb, Xoi, Tb^Tf, Uu, Wwg, Uu, Ur, Xoc, Uu^Emf, Xos, Ur, Uu, Wwg, Uu, Tb^Tf, Xos, Xoi, Xof, Xoi, Xoi, Xu, Xu
Xoi, Xoi, Xoi, Urb, Xoi, Urb, Xoi, Xoc, Uu^Vud, Uu, Isa, Ur, Xos, Uu^Emf, Xos, Ur, Isa, Uu, Uu^Vud, Xos, Xof, Xof, Iwo, Xof, Xof, Xu, Xu
Xoi, Xoi, Xoi, Urb, Urb, Urb, Xoi, Xoi, Xos, Isa, Isa, Xos, Xos, Xos, Xos, Xos, Isa, Isa, Xos, Xos, Iwo, Iwo, Urc, Iwo, Iwo, Xof, Xu
Xue, Xoi, Xoi, Xos, Xos, Urb, Urb, Xoi, Xos, Isa, Isa, Xoc, Xos, Xos, Xos, Xoc^Efs, Isa, Isa, Xos, Xos, Iwo, Iwo, Iwo, Iwo, Xof, Xoc, Xu
Xu, Xu, Xu, Xoi, Xoc, Xoc, Xos^Efs, Rr^Pr/o, Isa, Isa, Ur^Es, Isa, Tb^Tf, Uu^Eb, Uu, Ur, Ur, Isa^_mll, Isa, Rr^Pr\, Xos, Xos, Xoc, Xof, Xu, Xu, Xu
Wo, Wo, Wo, Xu, Isa, Xos, Isa, Isa, Isa, Ur^Es, Ww, Ww, Ww, Uu, Ww, Ww, Ww, Isa, Isa, Isa, Isa, Xos, Isa, Xu, Wo, Wo, Wo
Wo, Wo, Wo, Wo, Wo, Isa, Ww^Bsb\, Ww, Ww, Ww, Wo, Wo, Wo, Ww, Wo, Wo, Wo, Ww, Ww, Ww, Ww^Bsb/, Isa, Wo, Wo, Wo, Wo, Wo
Xu, Xu, Xu, Wo, Uu, Ww, Uu, Ur, Uu, Ww, Ww, Wo, Ww, Gd^Fetd, Ww, Wo, Ww, Ww, Uu, Ur, Uu, Ww, Uu, Wo, Xos, Xu, Xu
Xor, Xor, Xoi, Xor, Uu, Uu, Ur^Vud, Ur, Ur, Gll^Fdw, Tb^Tf, Ww, Gll^Fdw, Ww, Gll^Fdw, Ww, Tb^Tf, Tb^Tf, Ur, Ur, Ur^Vud, Uu, Uu, Xos, Xor, Xu, Xu
Xor, Xor, Xof, Xof, Rr^Pr\, Ur, Uu, Uu, Uu^Qhu, Ur^Qhu, Xos^Qhh, Gll^Fdw, Xos^Qhh, Gll^Fdw, Xos^Qhh, Tb^Tf, Xos^Qhh, Ur^Qhu, Uu^Qhu, Uu, Uu, Ur, Rr^Pr/, Xos, Xoc, Xor, Xoi
Xor, Xor, Xof, Iwo, Xof, Xos, Xos^Qhh, Xos^Qhh, Uu^Qhu, Ur^Qhu, Tb^Tf, Xos^Qhh, Xos^Efs, Xos^Qhh, Xos^Efs, Xos^Qhh, Tb^Tf, Ur^Qhu, Uu^Qhu, Xos^Qhh, Xos^Qhh, Xos, Xoc, Iwr^_s, Xoc, Xor, Xu
Xor, Xof, Iwo, Iwo, Iwo, Xof, Xos^Qhh, Uh, Xos^Efs, Ur^Edb, Ur^Edb, Tb^Tf, Ur, Ur^Vud, Ur^Edb, Tb^Tf, Ur, Ur^_ml, Xos^Efs, Uh, Xos^Qhh, Xoc, Xoc, Iwr^_s, Xoc, Xof, Xu
Xor, Xof, Iwo, Iwo, Iwo, Xof, Xos^Qhh, Uh, Uh, Uu^Edb, Ur^Edb, Ur^Edb, Cud^Edt, Uu^Edb, Cud^Edb, Ur^Edb, Ur^Edb, Uu, Uh, Uh, Xos^Qhh, Xof, Xoc, Xoc, Xoc, Xoc, Xu
Xor, Xof, Iwo, Urc, Iwo, Xof, Xoi^Qhh, Xos, Xos, Ur^Vud, Tb^Tf, Ur^Edt, Cud^Edt, Kud^Edb, Cud^Edb, Ur^Edb, Tb^Tf, Ur^Vud, Xos, Xos, Xor^Qhh, Xoc, Xoc, Xoc, Xoc, Xoc, Xoi
Xor, Xof, Xof, Iwo, Xof, Xof, Xor^Qhh, Xor, Xoi, Xos, Tb^Tf, Ur^Edt, Ur^Qhu, Cud^Edt, Ur^Qhu, Ur^Qhu, Tb^Tf, Xos, Xoi, Xor^Qhh, Xor, Xoc, Xoc, Xoc, Xoc, Xof, Xu
Xor, Xor, Xor, Xof, Xor, Xor, Xor^Qhh, Xor, Xor, Xos, Xos, Xos, Xos^Qhh, Ur^Qhu, Xos^Qhh, Xos, Xos, Xos, Xoi, Xoi^Qhh, Xoi, Xoc, Xoi, Xoc, Xoi, Xu, Xu
Xoi, Xor, Xor, Xor, Xor, Xor, Xoa, Xor^Qhh, Xor^Qhh, Xor, Xoi, Xos, Xos^Qhh, Ur^_mh, Xos^Qhh, Xoc^Qhh, Xor, Xor, Xor, Xor^Qhh, Xoa, Xor, Xor, Xor, Xor, Xu, Xu
Xoa^Qhh, Xoa^Qhh, Xoa^Qhh, Xoa, Xoa, Xoa, Xoa, Xoa, Xoa^Qhh, Xoa^Qhh, Xoa^Qhh, Xoa^Qhh, Xoa^Qhh, Ur^Qhh, Xoa^Qhh, Xoa^Qhh, Xoa^Qhh, Xoa, Xoa^Qhh, Xoa^Qhh, Xoa, Xoa, Xoa, Xoa, Xoa^Qhh, Xoa^Qhh, Xoa^Qhh
Uh, Uh, Uh, Xoa^Qhh, Xoa^Qhh, Xoa^Qhh, Xoa^Qhh, Xoa^Qhh, Uh, Xoa^Qhh, Uh^Edb, Uh^Edb, Ch^Edb, Ur, Ch^Edb, Uh^Edb, Uh, Xoa^Qhh, Uh, Xoa^Qhh, Xoa^Qhh, Xoa^Qhh, Xoa^Qhh, Xoa^Qhh, Mm, Mm, Mm
Hhd, Uh, Uh, Uh, Uh, Uh, Uh, Uh, Uh, Uh, Uh, Uh^Edb, Gll^Edb, Rp^Edb, Gll^Edb, Gll^Edb, Gd, Uh, Uh, Uh, Uh, Uh, Hhd, Mm, Mm, Mm, Mm
Hhd, Hhd, Hhd, Hhd, Hhd, Hhd, Gll, Gll, Gll, Gll, Gll, Gd, Gd, Rp^Edb, Gll, Gll^Edb, Gd, Gd, Gd, Hhd, Hhd, Hhd, Hhd, Mm, Mm, Mm, Mm
Gll, Hhd, Gll, Gll^Fmf, Gll^Fmf, Gll, Gll^Fmf, Gll^Fmf, Gll^Fmf, Gll, Gll, Gll^Es, Gll, Rp, Gll, Gll^_mhh, Gll, Gd, Gll, Gll, Gll, Gll^Fmf, Gll^Fmf, Gll^Fmf, Mm, Mm, Mm
Gll^Fdf, Gll^Fdf, Gll, Gll^Fmf, Gll^Fmf, Gll^Fmf, Gll^Fmf, Gll^Fdf, Gll^Fmf, Gll^Fmf, Gll^Edb, Gll, Gd, Rp, Gll, Gll, Gd, Gll^Ecf, Cer^Edb, Gll^Edb, Gll, Gll^Fmf, Gll^Fdf, Gll^Fdf, Mm, Mm, Mm
Rp, Gll^Fdf, Gll, Gll, Gll^Fdf, Gll^Fdf, Gll^Fdf, Gll^Fmf, Gll^Fdf, Gll, Gll, Gd^Edb, Gll^Edb, Rp, Rp^Edb, Gd^Edb, Gll, Cer^Edb, Ker^Edb, Cer^Edb, Gll^Fmf, Gll^Fmf, Gll^Fdf, Gll^Fdf, Mm, Mm, Mm
Gll, Rp, Rp, Gll, Gll, Gll^Fdf, Gd, Gll^Fdf, Gll^Fdf, Gll^Fdf, Gll, Gll^Edb, Gll^Edb, Rp^Edb, Rp^Edb, Rp^Edb, Rp^Edb, Cer^Edb, Cer^Edb, Cer, Gll, Gll^Fmf, Gll^Fmf, Gll^Fdf, Gll^Fmf, Mm, Rp
Gll, Gll, Gd^Es, Rp, Rp, Gd, Gd, Gll^Fmf, Gll^Fmf, Gll^Fdf, Gll^Fmf, Gll^Edb, Rp, Rp^Edb, Gll^Edb, Gll^Edb, Rp^Edb, Rp^Edb, Gll^Edb, Gll, Gll^Fmf, Gll, Gll^Fmf, Gll^Fmf, Rp, Rp, Mm
Gll, Gd, Gd, Gll, Rp, Gll, Gll^Ecf, Gll^Fmf, Cer^Edb, Gll^Fmf, Rp, Rp, Gll^Fdf, Gll^Fmf, Gll^Fdf, Gll, Rp, Rp^Edb, Gll^Edb, Gll^Edb, Gll, Gll, Rp, Rp, Hhd, Mm, Mm
Gll^Fmf, Gll, Gll^Fmf, Gll, Gll, Rp, Rp, Cer^Edb, Ker^Edb, Cer^Edb, Rp, Gll^Fmf, Gll^Fdf, Gll^Fdf, Gd, Gd, Gll, Rp, Rp, Gll^Edb, Gll, Rp, Gd, Hhd, Mm, Mm, Mm
Gll^Fdf, Gll^Fmf, Gll^Fmf, Gll^Fmf, Gll^Fmf, Gll, Rp, Cer^Edb, Cer, Cer^Edb, Rp, Gll^Fdf, Gll, Gll^Fdf, Gll^Es, Gd, Gll^Es, Gll^Es, Gll, Rp, Rp, Rp, Gll, Hhd, Hhd, Mm, Mm
Gll^Fdf, Gll^Fdf, Gll^Feth, Gll^Fmf, Gll^Fdf, Gll^Fmf, Gll, Rp, Rp, Rp^Edb, Rp^Edb, Gll, Gll, Gll, Gll, Gll^Es, Gll^Es, Gll, Gll, Rp, Rp, Gll, Gll, Gll^Fmf, Gll^Fmf, Hhd, Hhd
Gll^Fdf, Gll^Fdf, Gll^Fdf, Gll^Fdf, Gll^Fmf, Gll^Fmf, Gll^Fmf, Gll, Gll, Gll, Gll^Fmf, Rp, Rp, Gll^Fmf, Gll^Fmf, Gll, Gll^Fmf, Gll, Gll^Fmf, Gll, Rp, Rp, Gd, Gll, Gll, Hhd, Hhd
Gll^Fdf, Gll^Fdf, Gll^Fdf, Gll^Fdf, Gll, Gll^Fmf, Gll, Gll, Gll, Gll, Gll, Gll^Fmf, Gll, Rp, Gll, Gll^Fmf, Gll, Gll^Fmf, Gll, Gll, Rp, Rp, Rp, Gd, Gd, Gll, Gll
