Gg, Gg, Gg, Gg, Gg, Gg, Gg, Gg, Gg, Gg, Gg, Gg, Gg, Gg, Gg, Gg, Gg
Gg, Gg, Gg, Gg, Gg, Gg, Gg, Gg, Rrc, Gg, Gg, Gg, Gg, Gg, Gg, Gg, Gg
Gg, Gg, Gg, Gg, Gg, Gg, Rrc, Rrc, Gg, Rrc, Rrc, Gg, Gg, Gg, Gg, Gg, Gg
Gg, Gg, Gg, Gg, Rrc, Rrc, Gg, Gg, Rrc, Gg, Gg, Rrc, Rrc, Gg, Gg, Gg, Gg
Gg, Gg, Rrc, Rrc, Gg, Gg, Rrc, Rrc, Gg, Rrc, Rrc, Gg, Gg, Rrc, Rrc, Gg, Gg
Gg, Gg, Rrc, Gg, Rrc, Rrc, Gg, Gg, Rrc, Gg, Gg, Rrc, Rrc, Gg, Rrc, Gg, Gg
Gg, Gg, Rrc, Gg, Rrc, Gg, Rrc, Rrc, Gg, Rrc, Rrc, Gg, Rrc, Gg, Rrc, Gg, Gg
Gg, Gg, Rrc, Gg, Rrc, Gg, Rrc, Gg, 1 Rrc, Gg, Rrc, Gg, Rrc, Gg, Rrc, Gg, Gg
Gg, Gg, Rrc, Gg, Rrc, Gg, Rrc, Gg, Gg, Gg, Rrc, Gg, Rrc, Gg, Rrc, Gg, Gg
Gg, Gg, Rrc, Gg, Rrc, Gg, Gg, Rrc, Rrc, Rrc, Gg, Gg, Rrc, Gg, Rrc, Gg, Gg
Gg, Gg, Rrc, Gg, Gg, Rrc, Rrc, Gg, Gg, Gg, Rrc, Rrc, Gg, Gg, Rrc, Gg, Gg
Gg, Gg, Gg, Rrc, Rrc, Gg, Gg, Rrc, Rrc, Rrc, Gg, Gg, Rrc, Rrc, Gg, Gg, Gg
Gg, Gg, Gg, Gg, Gg, Rrc, Rrc, Gg, Gg, Gg, Rrc, Rrc, Gg, Gg, Gg, Gg, Gg
Gg, Gg, Gg, Gg, Gg, Gg, Gg, Rrc, Rrc, Rrc, Gg, Gg, Gg, Gg, Gg, Gg, Gg
Gg, Gg, Gg, Gg, Gg, Gg, Gg, Gg, Gg, Gg, Gg, Gg, Gg, Gg, Gg, Gg, Gg
