Gg, Gg, Gg, Gg, Gg, Gg, Gg, Gg, Gg, Gg, Gg, Gg, Gg, Gg, Gg, Gg, Gg
Gg, Gg, Gg, Gg, Gg, Gg, Gg, Gg, Rrc, Gg, Gg, Gg, Gg, Gg, Gg, Gg, Gg
Gg, Gg, Gg, Gg, Gg, Gg, Rrc, Rrc, Gg, Rrc, Rrc, Gg, Gg, Gg, Gg, Gg, Gg
Gg, Gg, Gg, Gg, Rrc, Rrc, Wog, Gg, Rrc, Gg, Gg, Rrc, Rrc, Gg, Gg, Gg, Gg
Gg, Gg, Rrc, Rrc, Wot, Wo, Wog, Rrc, Gg, Rrc, Rrc, Gg, Gg, Rrc, Rrc, Gg, Gg
Gg, Gg, Rrc, Gg, Wot, Wo, Wwg, Gg, Rrc, Gg, Gg, Rrc, Rrc, Gg, Rrc, Gg, Gg
Gg, Gg, Rrc, Gg, Wwt, Ww, Wwg, Rrc, Gg, Rrc, Rrc, Gg, Rrc, Gg, Rrc, Gg, Gg
Gg, Gg, Rrc, Gg, Wwt, Ww, Wwf, Gg, 1 Rrc, Gg, Rrc, Gg, Rrc, Gg, Rrc, Gg, Gg
Gg, Gg, Rrc, Gg, Wwr, Wwrg, Wwf, Gg, Gg, Gg, Rrc, Gg, Rrc, Gg, Rrc, Gg, Gg
Gg, Gg, Rrc, Wwrt, Wwr, Wwrg, Ss, Rrc, Rrc, Rrc, Gg, Gg, Rrc, Gg, Rrc, Gg, Gg
Gg, Gg, Rrc, Wwrt, Gg, Sm, Ss, Gg, Gg, Gg, Rrc, Rrc, Gg, Gg, Rrc, Gg, Gg
Gg, Gg, Gg, Rrc, Rrc, Sm, Gg, Rrc, Rrc, Rrc, Gg, Gg, Rrc, Rrc, Gg, Gg, Gg
Gg, Gg, Gg, Gg, Gg, Rrc, Rrc, Gg, Gg, Gg, Rrc, Rrc, Gg, Gg, Gg, Gg, Gg
Gg, Gg, Gg, Gg, Gg, Gg, Gg, Rrc, Rrc, Rrc, Gg, Gg, Gg, Gg, Gg, Gg, Gg
Gg, Gg, Gg, Gg, Gg, Gg, Gg, Gg, Gg, Gg, Gg, Gg, Gg, Gg, Gg, Gg, Gg
