Gll^Fp, Gll^Fp, Gll^Fp, Gll^Fp, Gll^Fp, Gll^Fp, Gll^Fp, Gll^Fp, Gll^Fp, Gll^Fp, Gll^Fp, Gll^Fp, Gll^Fp, Gll^Fp, Gll^Fp, Gll^Fp, Gll^Fp, Gll^Fp, Gll^Fp, Gll^Fp, Gll^Fp, Gll^Fp, Gll^Fp, Gll^Fp, Gll^Fp, Gll^Fp, Gll^Fdw, Gll^Fp, Gll^Fp, Re^Edb, Gll^Fp, Gll^Fp, Gll^Fp, Gll^Fp, Gll^Fp, Gll^Fp, Gll^Fp, Gll^Fp, Gll^Fp, Gll^Fp, Gll^Fdw, Gll^Fp, Gll^Fp, Re^Edb, Re^Edb, Gll^Fp, Gll^Fp, Gll^Fp, Gll^Fp, Gll^Fp, Wwg, Gll^Fp, Gll^Fp, Gll^Fp, Gll^Fp, Gll^Fp, Gll^Fp, Gll^Fp, Gll^Fp, Gll^Fp, Gll^Fp, Gll^Fp
Gll^Fp, Gll^Fp, Gll^Fp, Gll^Fp, Gll^Fp, Gll^Fp, Gll^Fmf, Gll^Fp, Gll^Fp, Gll^Fp, Gll^Fp, Gll^Fp, Gll^Fdf, Gll^Fp, Gll^Fp, Gll^Fp, Gll^Fmf, Gll^Fp, Gll^Fp, Gll^Fp, Gll^Fp, Gll^Fp, Gll^Fp, Gll^Fp, Gll^Fdw, Gll^Fdw, Gll^Fdw, Gll^Fp, Gll^Fp, Re^Edb, Re^Edb, Gll^Fmf, Gll^Fmf, Gll^Fp, Gll^Fp, Gll^Fp, Gll^Fp, Gll^Fp, Gll^Fdw, Gll^Fp, Gll^Fp, Gll^Fp, Re^Edb, Re^Edb, Gll^Fp, Gll^Fp, Gll^Fp, Gs^Vl, Gll^Fp, Gll^Fp, Gll^Fp, Wwg, Wwg, Gll^Fp, Gll^Fp, Gll^Fp, Gll^Fp, Gll^Fp, Gll^Fp, Gll^Fp, Gll^Fp, Gll^Fp
Gll^Fp, Gll^Fp, Gll^Fp, Gll^Fp, Gll^Fp, Gd^Fdf, Gll^Fmf, Gll^Fmf, Gd^Fdf, Gd^Fdf, Gll^Fdw, Gll^Fdw, Gll^Fp, Gll^Fdf, Gll^Fp, Gll^Fmf, Gll^Fp, Gll^Fmf, Gll^Fmf, Gll^Fmf, Gll^Fp, Gll^Fp, Gll^Fdw, Gll^Fdw, Gll^Fdw, Gll^Fp, Gd^Fmf, Gll^Fdw, Gll^Fdw, Gll^Fp, Gll^Fp, Re^Edb, Gll^Fp, Gll^Fmf, Gll^Fp, Gd^Fmf, Gd^Fmf, Gll^Fdw, Gll^Fdw, Gll^Fp, Re^Edb, Re^Edb, Gll^Fp, Gll^Fp, Gll^Fmf, Gll^Fdw, Gll^Fmf, Gll^Fp, Gll^Fp, Gll^Fdw, Gll^Fdw, Gll^Fp, Gll^Fp, Wwg, Gll^Fmf, Gll^Fp, Gll^Fmf, Gll^Fp, Gll^Feth, Gll^Fp, Gll^Fp, Gll^Fp
Gll^Fp, Gll^Fp, Gll^Fmf, Gll^Fp, Gll^Fmf, Gd^Fdf, Gd^Fdf, Gd^Fdf, Gd^Fdf, Gd^Fdf, Gll^Fp, Gll^Fp, Gll^Fmf, Gll^Fdf, Gll^Fdf, Gll^Fp, Gll^Fmf, Gll^Fp, Gll^Fmf, Gll^Fmf, Gll^Fdw, Gll^Fdw, Gll^Fdw, Gll^Fdw, Gll^Fp, Gd^Fmf, Gll^Fp, Gll^Fp, Gll^Fp, Gll^Fmf, Gll^Fp, Re^Edb, Re^Edb, Gll^Fp, Gll^Fp, Gll^Fp, Gd^Fmf, Gll^Fdw, Gd^Fp, Gll^Fdw, Re^Edb, Re^Edb, Gll^Fdw, Gll^Fdw, Gll^Fdw, Gll^Fdw, Gll^Fdw, Gll^Fmf, Gll^Fmf, Gll^Fp, Gll^Fdw, Gll^Fdw, Gll^Fp, Wwg, Wwg, Gll^Fp, Gll^Fp, Gll^Fmf, Gll^Fp, Gll^Fp, Gll^Fp, Gll^Fp
Gll^Fp, Gll^Fp, Gll^Fp, Gll^Fmf, Gd^Fdw, Gd^Fdw, Gd^Fdw, Gd^Fdf, Gll^Fp, Gll^Fp, Gll^Fp, Gll^Fmf, Gll^Fmf, Gll^Fp, Gll^Fp, Gll^Fp, Gll^Fmf, Gll^Fmf, Gd^Fp, Gd^Fp, Gll^Feth, Gll^Fmf, Gd^Fp, Gd^Fmf, Gd^Fmf, Gd^Fmf, Gd^Qhux, Gd^Qhux, Gll^Fmf, Gll^Fmf, Gll^Fmf, Gll^Fp, Re^Edb, Gll^Fp, Gll^Fp, Gll^Fp, Gd^Fmf, Gd^Fp, Gd^Fp, Gll^Fdw, Gll^Fp, Re^Edb, Re^Edb, Gll^Fp, Gll^Fp, Gll^Fp, Gll^Fp, Gll^Fdw, Gll^Fp, Gll^Fmf, Gll^Fp, Gll^Fdw, Gll^Fp, Gll^Fp, Gll^Fdw, Wwg, Wwg, Gll^Fp, Gll^Fmf, Gll^Fmf, Ww^Vm, Wwg
Gll^Fp, Gll^Fp, Gd^Fdw, Gd^Fdw, Gll^Fmf, Gll^Fmf, Gd^Fdw, Gd^Fdf, Gll^Fp, Gll^Fp, Gd, Gll^Fp, Gll^Fp, Gll^Fp, Gll, Gll^Fp, Gll^Fmf, Gd^Fp, Gll^Fmf, Gd^Fp, Gd^Fp, Gd^Fp, Gd^Fp, Gd^Fmf, Gd^Fmf, Gd^Fmf, Gd^Qhux, Gd^Qhux, Gll^Fmf, Gll^Fmf, Gll^Fmf, Gll^Fmf, Re^Edb, Gll^Edb, Gll^Fp, Gll^Fp, Gd^Fmf, Gd^Fp, Gd^Fp, Gll^Edb, Gll^Edb, Gll^Fp, Re^Edb, Gll^Fp, Gll^Fp, Gll^Fp, Gll^Fp, Gll^Fp, Gll^Fp, Gll^Fp, Gll^Fp, Gll^Fp, Gll^Fp, Gll^Fp, Gll^Fp, Gll^Fdw, Wwg, Gll^Fdw, Wwg, Wwg, Gll^Fdw, Gll^Fp
Gll^Fp, Gll^Fp, Gll^Fp, Gll^Fmf, Gll^Fp, Gll^Fmf, Gll^Fmf, Gll^Fp, Gll, Gll, Gll^Edb, Gd, Gd, Gll, Gll^Edb, Gll^Fp, Gll^Fmf, Gll^Fmf, Gd^Fp, Gd^Fp, Gd^Qhux, Gd^Qhux, Gd^Qhux, Gd^Qhux, Gd^Qhux, Gd^Qhux, Gll, Gd^Qhux, Gll^Fmf, Gll^Edb, Gll^Edb, Gll^Fmf, Re^Edb, Gll^Edb, Gll^Fp, Gd^Fmf, Gd^Fmf, Gd^Fp, Gd^Fp, Gll^Edb, Gll^Edb, Gll^Edb, Re^Edb, Gll, Gll, Gll, Gll, Gll^Fp, Gll, Gll, Gll, Gll, Gll, Gll^Fp, Gll^Fp, Gll^Fp, Wwg, Wwg, Gll^Fmf, Gll^Fdw, Gll^Fp, Gll^Fp
Gll^Fp, Gll^Fp, Gll^Fp, Gll^Fmf, Gll^Fmf, Gll^Fmf, Gll^Fmf, Gll, Gll^Edb, Gll, Gll^Edb, Gd^Edb, Gd^Vhr, Gll^Edb, Gll^Edb, Gll, Gll, Gd^Fp, Gll, Gll, Gll, Gd^Qhux, Gll, Gll, Gll, Gd^Qhux, Gll, Gll, Gll^Fmf, Gll^Edb, Gll^Edb, Gll^Edb, Re^Edb, Gll^Edb, Gll^Edb, Gd^Fmf, Gd^Fmf, Gd^Fmf, Gll^Edb, Gll^Edb, Gll, Re^Edb, Gll, Gll, Gll^Qhux, Gll, Gll^Qhux, Gll^Qhux, Gll^Qhux, Gll, Gll, Gd, Gll, Gll, Gll, Gll^Fp, Wwg, Gll^Fmf, Gll^Fmf, Gll^Fp, Gll^Fp, Gll^Fp
Re, Gll^Fp, Re, Gll^Fp, Gll, Gll^Fmf, Gll, Gll, Gd^Edb, Gll^Edb, Gll^Edb, Gd^Edb, Gd^Edb, Gd^Edb, Gd^Edb, Gll, Gll, Gll, Gll, Gll^Edb, Gll^Edb, Gll^Edb, Gll^Edb, Gll, Gll^Edb, Gll, Gll^Edb, Gll, Gll, Gll^Vhr, Re, Re^Edb, Gll, Gll^Edb, Gll^Edb, Gll^Edb, Gll^Edb, Gll^Edb, Gll^Edb, Gll^Edb, Re, Re, Gll^Qhux, Gll^Qhux, Gll, Gll^Qhux, Gll, Gll^Qhux, Gll^Qhux, Gll, Gll, Gll^Vhr, Gll, Gll, Gll, Wwg, Gll, Gll^Fp, Gll^Fp, Gll^Fmf, Gll^Fmf, Gll^Fp
Gd^Qhhf, Re, Gd^Qhhf, Re, Re, Gll, Re, Gll^Edb, Re, Gll^Edb, Re, Gll^Edb, Gll, Gll, Gll, Gll^Edb, Gll, Gll, Gll, Gll^Edb, Gll, Gll, Gll, Gll^Edb, Gll^Edb, Gll^Edb, Gll, Gll^Edb, Gll, Re, Gll, Re, Gd, Gll, Gll^Edb, Gll^Edb, Gll, Gll^Edb, Re, Re, Gll, Gll, Gll, Gll^Qhux, Gll^Qhux, Gll^Qhux, Gll^Qhux, Gll^Qhux, Gll^Qhux, Gll^Qhux, Gll, Gd, Gll, Gll, Wwg, Wwg, Gll, Gll, Gll, Gll^Fp, Gll^Fp, Gll^Fmf
Gll^Fmf, Gd^Qhhf, Gll^Fmf, Gd^Qhhf, Gd^Qhhf, Re, Gll, Re, Gll, Re, Gll, Re, Re, Gll, Re, Gll, Re, Gll, Gll, Gd, Gd, Gll, Gd, Gll, Gll^Edb, Gll^Edb, Gll^Edb, Gll, Re, Re, Gd, Gd, Gll, Gll, Gll, Gll^Edb, Re, Re, Gll, Gll, Gd, Gll, Gll, Gll, Gll, Gll^Qhux, Gll, Gll^Qhux, Gll, Gll, Gll, Gll, Wwg, Wwg, Hhd, Gll, Gll, Gll, Gd, Gll, Gll, Gll
Gd, Gll^Fmf, Gd^Fetd, Gll^Fmf, Gll^Fmf, Gd^Qhhf, Gd^Qhhf, Gll^Fmf, Gll^Fmf, Gll^Fmf, Gll^Fmf, Gll, Gll, Re, Gll, Re, Gd^Vhr, Re, Re, Gll, Gll, Gd, Gll, Gll, Gll, Gll, Gll, Gll, Re, Gll, Gll, Gll, Re, Re, Re, Re, Re, Re, Gd, Gd, Gll, Gll, Gll, Gll, Gll, Gll, Gll, Gll, Gll, Gll, Gll, Wwg, Wwg, Hhd, Hhd, Gll^Fmf, Gd, Gll, Gll, Gll, Gll, Gll
Gll^Fmf, Gll^Fmf, Gll^Fmf, Gll^Fmf, Gll^Qhhf, Gll^Qhux, Gll^Qhux, Gd^Qhhf, Gll^Qhux, Gll^Fmf, Gll^Fmf, Gd, Gd, Gll, Gd, Gd, Gd, Gll, Gll, Re, Re, Gll, Re, Gll, Gll, Gll, Gll, Gll, Re, Re, Re, Re, Gll, Gll, Wwg, Gll, Gll, Gll, Gll, Gd, Gd, Gd, Wwg, Wwg, Wwg, Wwf, Wwf, Wwf, Wwf, Wwf, Wwg, Wwg, Gll^Fmf, Hhd, Gll^Fmf, Gll^Fmf, Gd, Gd, Gd, Gd, Gll, Gll
Gg, Gll^Fmf, Gll^Qhhf, Gll^Qhhf, Gll^Qhux, Gll^Fdf, Gll^Qhux, Gll^Qhux, Gll^Qhux, Gll^Fdf, Gll^Fmf, Gll^Fmf, Gll, Gd, Gll, Gd, Gll, Gll, Gll, Gll, Gll, Re, Gll, Re, Re, Gll, Re, Gll, Re, Gll, Wwg, Gll, Wwg, Wwg, Gll, Wwg, Wwg, Gll, Gll, Gll, Wwg, Wwg, Gll, Gll, Gll, Gll, Sm, Sm, Gll, Gll, Gll, Gll^Fmf, Gll^Fmf, Hhd, Gd, Gd, Gll, Gll, Gll^Qhh, Gll, Gll, Gll
Wwg, Gll^Fdf, Gll^Fdf, Gll^Qhhf, Gll^Qhhf, Gll^Qhux, Gll^Qhux, Gll^Qhux, Gll^Fmf, Gll^Fmf, Gll, Gll, Gll, Gll, Wwg, Gll, Gll, Gll, Wwg, Gll, Gll, Gll, Gll, Gll, Gll, Re, Gll, Re, Wwg^Bw\, Wwg, Gll, Wwg, Gll, Gll, Gll, Gll, Wwf, Wwf, Wwf, Wwg, Gll, Wwg, Gll, Gll, Gd^Fetd, Gll, Sm, Sm, Gll, Gll, Gll, Gll^Fmf, Gll^Fmf, Gd, Gll, Gll, Gll, Gll^Qhh, Hhd^Qhh, Gll^Qhh, Gll^Qhh, Gll^Qhh
Gll, Wwg, Wwg, Gll, Gll, Gll^Fdf, Gll^Fdf, Gll^Qhux, Gll, Gll^Fdf, Gll, Gll, Wwg, Wwg, Gll, Wwg, Wwg, Wwg, Wwg, Wwf, Wwf, Gll, Ww^Vm, Gll, Gll, Gll, Wwg, Wwg, Gll, Re, Re, Gll, Gll, Gll, Wwf, Wwf, Gll, Sm, Sm, Gll, Gll, Gll, Gd, Gd, Gd, Sm, Sm, Sm, Sm, Sm, Sm, Gll, Gll, Gll, Gll, Gll, Gll, Gll^Qhh, Hhd^Qhh, Gll^Qhh, Hhd^Qhh, Hhd^Qhh
Gll, Gll, Gll, Wwg, Wwg, Gll, Gll, Gll, Gll, Gll, Wwg, Wwg, Gll, Gll, Gll^Vhr, Gll, Wwg, Wwg, Wwg, Wwf, Wwf, Wwf, Wwg, Wwg, Wwg, Wwg, Wwg, Wwg, Wwg, Wwg, Wwg^Bw|, Wwg, Wwg, Wwf, Sm, Sm, Gll, Sm, Sm, Sm, Sm, Sm, Sm, Gd, Gd, Gll, Sm, Sm, Cer^Qhh, Cer^Qhh, Cer^Qhh, Gll, Gd, Gd, Gll, Gll, Gll^Qhh, Gll^Qhh, Hhd^Qhh, Hhd^Qhh, Md, Hhd
Gll, Gll, Gll, Gll, Wwg, Gll, Gd, Gll, Gll, Gll, Wwg, Wwg, Gll, Gll, Wwg^Bw|r, Gll, Wwg, Wwg, Wwg, Wwf, Wwf, Wwf, Wwf, Wwg, Gll^Qhh, Gll^Qhh, Gll^Qhh, Gll^Qhh, Gll^Qhh, Gll^Qhh, Re^Qhh, Gll^Qhh, Gll^Qhh, Gll^Qhh, Sm, Gll, Gll, Md, Md, Md, Md, Sm, Sm, Sm, Sm, Sm, Cer^Qhh, Cer^Qhh, Rb, Rb, Rb, Gll, Gll, Gll, Gll, Gll, Gll^Qhh, Hhd^Qhh, Hhd, Md, Md, Md
Gll, Gll, Gll, Gll, Wwg, Gll, Gll, Gll, Gll, Gll, Wwg, Wwg, Wwg, Wwg, Gll, Wwg, Wwg, Wwg, Wwf, Wwf, Sm, Wwf, Sm, Gll^Qhh, Sm, Sm, Sm, Sm, Gll^Qhh, Gll, Gll, Re, Gll^Qhh, Sm, Sm, Sm, Sm, Gll, Sm, Md, Sm, Sm, Gll, Sm, Cer^Qhh, Cer^Qhh, Rb, Rb, Rb, Rb, Gll, Gll, Gll, Gd, Gll, Gll^Qhh, Hhd^Qhh, Hhd^Qhh, Hhd^Qhh, Md, Md, Md
Gll, Gll, Gll, Gll, Wwg, Gll, Gll, Gd, Wwg^Bw\, Wwg, Gll, Gll, Gll, Gll, Gll, Gll, Gll, Gll^Qhh, Gll^Qhh, Sm, Sm, Sm, Sm, Sm, Sm, Sm, Cer^Qhh, Cer^Qhh, Cer^Qhh, Gll, Gll, Re, Gll^Qhh, Cer^Qhh, Cer^Qhh, Sm, Cer^Qhh, Sm, Sm, Sm, Gll, Gd, Gd, Gll, Rb, Rb, Rb, Rb, Gd^Vhr, Gll, Gll, Gll, Gg^Vwm, Gll, Gll, Gll^Qhh, Gll^Qhh, Gll^Qhh, Gll^Qhh, Hhd^Qhh, Hhd^_mh, Md
Gll, Gll, Gd, Gd, Gll, Wwg, Wwg, Wwg, Gll, Gll, Gll, Gll, Gll, Gll, Gll, Gll, Gll, Gll^Qhh, Gll, Gll^Qhh, Sm, Sm, Cer^Qhh, Cer^Qhh, Cer^Qhh, Cer^Qhh, Rb, Rb, Rb, Gll, Gll, Re, Gll^Qhh, Rb, Rb, Rb, Rb, Cer^Qhh, Rb, Cer^Qhh, Gll, Gll, Rb, Gll, Rb, Rb, Gll, Gll, Gll, Gll, Gd, Gll, Gll, Gll, Gll, Gll, Gll^Qhh, Gll^Qhh, Gll^Qhh, Hhd^Qhh, Hhd, Hhd
Gll, Gll, Gd^Vhr, Gll, Gd, Gll, Wwg, Wwg, Gll, Gll, Gd, Gd, Gll, Gll, Gll, Gll, Gll, Gll^Qhh, Gll, Gll^Qhh, Cer^Qhh, Cer^Qhh, Rb, Rb, Rb, Rb, Rb, Rb, Rb, Gll, Gll, Re, Gll, Gll^Qhh, Rb^Qhh, Rb, Gll, Rb, Rb, Rb, Rb, Rb, Gd, Rb, Gd, Gll, Gll, Gll, Gll, Gd, Gll, Gll, Gd, Gll, Gll, Gll, Gll^Qhh, Gll^Qhh, Hhd^Qhh, Hhd^Qhh, Hhd, Hhd
Gll, Gd, Gd, Gd, Gd, Gll, Wwg, Gll, Gll, Gll, Gd, Gd^Vhr, Gd, Gll, Gd, Gll, Gll, Gll^Qhh, Gll^Qhh, Gll, Gll, Rb, Gll, Gll^_mh, Gll, Gll, Gll, Rb, Gll, Rb, Rb, Rb, Rb, Rb, Gll, Rb^Qhh, Gll^Qhh, Gll, Gll, Gll, Gll, Gll, Gll, Gd, Gll, Gll, Gd, Gd, Gd, Gd, Gll, Gd, Gll, Gll, Gll^Qhh, Gll^Qhh, Hhd^Qhh, Gll^Qhh, Hhd^Qhh, Hhd, Hhd, Hhd
Gll, Gd, Gd, Gd, Wwg, Wwg^Bw\, Gll, Gll, Gll, Gll, Gd, Gd, Gd, Gd, Gll, Gll, Gd, Gll, Gll^Qhh, Gll, Gll, Gll, Gd, Gll, Gll, Gll, Gll, Gll, Sm, Gll, Ce, Rb, Ce, Gll, Sm, Gll, Gll, Gll^Qhh, Gll^Qhh, Gll^Qhh, Gll^Qhh, Gll^Qhh, Gll^Qhh, Gll, Gll^Fmf, Gll, Gll, Gd, Gll, Gd, Gll, Gd, Gll, Gll, Gll^Qhh, Gll^Qhh, Gll^Qhh, Hhd^Qhh, Hhd^Qhh, Hhd, Hhd, Hhd
Gll, Gd, Gll, Gll, Wwg, Gll, Gll, Gll, Gll, Gd, Gll, Gll, Hhd, Md, Md, Gd, Gll, Gll, Gll, Gll^Qhh, Gll, Gd, Gd, Gd, Gll, Gll, Sm, Sm, Ce, Ce, Rb, Rb, Rb, Ce, Ce, Sm, Sm, Gll, Gll, Gll, Gll, Gll, Gll^Qhh, Gll^Fmf, Gd^Fp, Gd^Fp, Gll, Gll, Gll, Gll, Gll, Gll, Gll^Qhh, Gll^Qhh, Gd^Qhh, Gd^Qhh, Gll^Qhh, Gll^Qhh, Hhd^Qhh, Hhd, Hhd, Hhd
Gll, Gll, Gll, Gll, Wwg, Gll, Gll, Gll, Gll, Gll, Gll^Eff, Gll, Hhd, Md, Md, Md, Gll, Gll, Gll, Gll^Qhh, Gll^Qhh, Gd, Gd, Gd, Gll, Sm, Ce, Ce, Rb, Rb, Rb, Rb, Rb, Rb, Rb, Ce, Ce, Sm, Gll, Gd, Gll, Gll, Gll^Qhh, Gll^Fmf, Gd^Fp, Gll^Fmf, Gll^Fmf, Gll, Gll, Gll, Gll, Gll^Qhh, Gll^Qhh, Gll^Qhh, Gll^Qhh, Gd^Qhh, Hhd^Qhh, Gll^Qhh, Hhd^Qhh, Hhd, Hhd, Hhd
Gll, Gll, Gll, Wwg, Gll, Gll, Gll, Gll, Gll^Eff, Gll^Eff, Rb^Gvs, Gll^Eff, Gll^Eff, Gll, Hhd, Hhd, Gll, Gll^Wm, Gll, Gll, Gll^Qhh, Gd, Gd, Gll, Gll, Sm, Ce, Re^Vct, Rb, Ce, Ce, Re^Vct, Ce, Ce, Rb, Re^Vct, Ce, Sm, Gd, Gll, Gll, Gll^Qhh, Gll^Fmf, Gll^Fmf, Gd^Fp, Gd^Fetd, Gll^Fmf, Gll, Gll, Gll, Gll^Qhh, Gll^Qhh, Gll^Qhh, Hhd^Qhh, Hhd^Qhh, Hhd^Qhh, Hhd, Hhd^Qhh, Hhd, Hhd^Vhhr, Hhd, Hhd
Gll, Gll, Gll, Wwg, Gll, Gll, Gll^Eff, Gll^Eff, Rb^Gvs, Rb^Gvs, Rb^Gvs, Rb^Gvs, Rb^Gvs, Gll^Eff, Gll^Eff, Gll, Gll, Gll, Gll, Gll, Gll, Gll^Qhh, Gll^Qhh, Gll, Gll, Sm, Ce, Rb, Rb, Re^Vct, Ce, Ke, Ce, Re^Vct, Rb, Rb, Ce, Sm, Gll, Gll, Gll^Qhh, Gll^Qhh, Gll^Fp, Gll^Fmf, Gll^Fmf, Gll^Fmf, Gll^Fmf, Gll^Fmf, Gll, Gll^Qhh, Gll^Qhh, Gd^Qhh, Gd^Qhh, Hhd^Qhh, Hhd^Qhh, Hhd, Hhd, Hhd, Hhd, Hhd, Hhd, Hhd
Gll, Gll, Gll, Wwg, Gll, Gll^Eff, Gll^Eff, Rb^Gvs, Rb^Gvs, Rb^Gvs, Rb^Gvs, Rb^Gvs, Rb^Gvs, Rb^Gvs, Rb^Gvs, Gll^Eff, Gll^Eff, Gll, Gll, Gll, Gll, Gll, Gll^Qhh, Gll, Gll, Sm, Ce, Rb, Rb, Re^Vct, Ce, Rb^Ecf, Ce, Re^Vct, Rb, Rb, Ce, Sm, Gll, Gll^Qhh, Gll^Fp, Gll^Fp, Gll^Fmf, Gll^Fp, Gll^Fmf, Gll^Fmf, Gd^Fp, Gll, Gll, Gll^Qhh, Hhd^Qhh, Gll^Qhh, Gd^Qhh, Gll^Qhh, Gll^Qhh, Hhd^Qhh, Hhd, Hhd, Md, Md, Md, Hhd
Gll, Gll, Gll, Wwg, Wwg, Gll, Gll, Gll^Eff, Gll^Eff, Rb^Gvs, Rb^Gvs, Rb^Gvs, Rb^Gvs, Rb^Gvs, Rb^Gvs, Rb^Gvs, Rb^Gvs, Gll^Eff, Gll^Eff, Gll, Gll, Gll, Gll^Qhh, Gll^Qhh, Gll, Sm, Ce, Re^Vct, Rb, Ce, Rb, Rb, Rb, Ce, Rb, Re^Vct, Ce, Sm, Gll, Gll^Qhh, Gll^Fp, Gll^Fmf, Gll^Fmf, Gll^Fmf, Gll^Fmf, Gd^Fp, Gll^Fdf, Gll, Gll^Qhh, Gll^Qhh, Hhd^Qhh, Gll^Qhh, Gll^Qhh, Gll^Qhh, Hhd^Qhh, Hhd^Qhh, Md, Md, Md, Md, Md, Md
Gll, Gll, Gll, Gll, Wwg, Gll^Wm, Gll, Gll, Gd, Gll^Eff, Gll^Eff, Rb^Gvs, Rb^Gvs, Rb^Gvs, Rb^Gvs, Rb^Gvs, Re, Gll^Eff, Gll, Gll, Gd, Gll, Gll, Gll^Qhh, Gll, Sm, Sm, Ce, Ce, Rb, Rb, Rb, Rb, Rb, Ce, Ce, Sm, Sm, Gll, Gll^Qhh, Gll, Gll^Fmf, Gll^Fdf, Gll^Fdf, Gll^Fmf, Gd^Fp, Gll^Fdf, Gll, Gll, Gll^Qhh, Gll^Qhh, Hhd^Qhh, Hhd^Qhh, Hhd^Qhh, Hhd^Qhh, Hhd, Md, Md, Md, Md, Md, Md
Gll, Gll, Gll, Gll, Gll, Wwg, Gll, Gll, Gd, Gd, Gd, Gll^Eff, Gll^Eff, Rb^Gvs, Gd^Eff, Gd^Eff, Gll, Re, Gll, Gd, Gd, Gd, Gll, Gll^Qhh, Gll^Qhh, Gll, Gll, Sm, Sm, Ce, Rb, Rb, Rb, Ce, Sm, Sm, Gll, Gll, Gll, Gll^Qhh, Gll^Qhh, Gll^Fmf, Gll^Fdf, Gd^Fp, Gd^Fp, Gd^Fp, Gll^Fmf, Gll, Gll, Gll^Qhh, Gll^Qhh, Gll^Qhh, Gll^Qhh, Gll^Qhh, Hhd^Qhh, Hhd, Md, Md, Md, Md, Hhd, Hhd
Ds, Ds, Ds, Ds, Ds, Wwg, Ds, Gll, Ds, Gd, Gd, Gll, Gll, Gll, Gll, Gll, Gll, Re, Re, Gd, Gll, Gll, Gll^Vc, Gll, Gll^Qhh, Gll, Gll, Gll, Gll, Gll, Rb, Rb, Rb, Gll, Gll, Gll, Gll, Gll, Gll, Gs^Vh, Gll^Qhh, Gll, Gll, Gll^Fdf, Gll, Gd^Fp, Gll, Gll, Gll, Gll^Qhh, Gll^Qhh, Gll^Qhh, Gll^Qhh, Gll^Qhh, Hhd^Qhh, Hhd, Hhd, Md, Hhd, Hhd^Vhhr, Hhd, Hhd
Ww^Wkf, Ww^Wkf, Ww^Wkf, Ww^Wkf, Ds, Wwg, Wwg, Ds, Ds, Ds, Ds, Gll, Ds, Gll, Gll, Gll, Gll, Gll^Vhr, Re, Re, Re, Re, Re, Re, Re^Qhh, Gll, Re, Gll, Re, Gll, Re, Rb, Rb, Gll, Gll, Gll, Rb, Rb, Gll, Gll, Gll^Qhh, Gll, Gll, Gll, Gll, Gll, Gll, Gll, Gll, Gll^Qhh, Gll^Qhh, Hhd^Qhh, Gll^Qhh, Hhd^Qhh, Hhd, Hhd, Hhd, Hhd, Hhd, Hhd, Hhd, Hhd
Wwg, Ww^Wkf, Ww^Wkf, Ww^Wkf, Wwg, Ds, Wwg, Wwg, Wwg, Wwg, Wwg, Ds, Ds, Ds, Ds, Ds, Ds, Re, Gll, Gll, Gll, Gll, Gll, Re, Gll^Qhh, Re, Gll, Re, Gll, Re, Re, Re, Rb, Rb, Rb, Rb, Gll, Rb, Gll^Qhh, Gll^Qhh, Gll, Gll, Gd, Gll, Gd, Gll, Gll, Gll, Gll, Gll, Gll^Qhh, Hhd^Qhh, Hhd^Qhh, Hhd^Qhh, Hhd, Hhd, Hhd, Hhd, Hhd, Hhd, Hhd, Hhd
Wwg, Wwg, Wwg, Ww^Wkf, Wwg, Wwg, Wwg, Wwg, Ww^Wkf, Ww^Wkf, Ww^Wkf, Ww^Wkf, Ww^Wkf, Ds, Wwg, Ds, Wwg, Ds, Ds, Ds, Ds, Gll, Gll, Gll, Gll, Gll^Qhh, Gll^Qhh, Gll, Gll, Gll, Gd, Gll, Gll, Rb, Rb, Rb, Rb, Gll, Gll^Qhh, Gll, Gll, Gd, Gd, Gd, Gd, Gll, Gll, Gll, Gll, Gll, Gll^Qhh, Gll^Qhh, Hhd^Qhh, Hhd, Hhd, Hhd, Hhd, Hhd, Hhd, Hhd, Hhd, Hhd
Wog, Wog, Wog, Wog, Wog, Wog, Wog, Wwg, Wog, Wwg, Ww^Wkf, Wwg, Wwg, Wwg, Wwg, Wwg, Wwg, Ds, Wwg, Wwg, Wwg, Ds, Ds, Gll, Gll, Gll, Gll, Gll^Qhh, Gll^Qhh, Gll, Gd, Gd, Gd^_mh, Gd, Rb, Rb, Rb, Rb, Gll^Qhh, Rb, Gll, Gll, Gll, Gll, Gs^Vh, Gll, Gd, Gll, Gll, Gll, Gll^Qhh, Gll^Qhh, Gll^Qhh, Hhd^Qhh, Hhd^Qhh, Hhd, Hhd, Hhd, Hhd, Hhd, Hhd, Hhd
Wog, Wog, Wog, Wog, Wog, Wog, Wog, Wog, Wog, Wog, Wog, Wog, Wog, Wwg, Wog, Wwg, Wwg, Wwg, Wwg, Wwg, Wwg, Wwg, Wwg, Ds, Ds, Gd^Vl, Ds, Gll, Gll, Gll^Qhh, Gd^Qhh, Gll, Gd, Gll, Rb, Gll, Rb, Rb, Rb^Qhh, Rb, Gll, Gll, Gll, Gll, Gd, Gd, Gll, Gd, Gll, Gll, Gll, Gll^Qhh, Gll^Qhh, Gll^Qhh, Hhd^Qhh, Hhd, Hhd, Hhd^_mh, Hhd, Hhd, Hhd, Hhd
Wog, Wog, Wog, Wog, Wog, Wog, Wog, Wog, Wog, Wog, Wog, Wog, Wog, Wog, Wog, Wog, Wog, Wwg, Wwg, Wwg, Wwg, Ww^Wkf, Ww^Wkf, Ww^Wkf, Ww^Wkf, Ds, Wwg, Ds, Gll, Gll, Gll, Gd^Qhh, Gll^Qhh, Gll, Gll, Gll, Gll^Qhh, Rb^Qhh, Rb, Rb, Gll, Gll, Gd, Gd, Gd, Gll, Gd, Gd, Gll, Gll, Gll^Qhh, Gll^Qhh, Gll^Qhh, Hhd^Qhh, Hhd, Hhd, Hhd, Hhd, Hhd, Hhd, Md, Md
Wog, Wog, Wog, Wog, Wog, Wog, Wog, Wog, Wog, Wog, Wog, Wog, Wog, Wog, Wog, Wog, Wog, Wog, Wog, Wog, Wwg, Wwg, Wwg, Ww^Wkf, Ww^Wkf, Ww^Wkf, Wwg, Ds, Ds, Gll, Gll, Gll, Gll, Gll^Qhh, Gll^Qhh, Gll^Qhh, Gll, Gll, Rb, Rb, Gll, Gll, Gll, Gd, Gll, Gll, Gll^Qhh, Gll, Gll^Qhh, Gll^Qhh, Gll^Qhh, Gll^Qhh, Hhd^Qhh, Hhd^Qhh, Hhd, Hhd, Hhd, Hhd, Hhd, Md, Md, Md
Wog, Wog, Wog, Wog, Ds^Qhh, Wog, Wog, Wog, Wog, Wog, Wog, Wog, Wog, Wog, Wog, Wog, Wog, Wog, Wog, Wog, Wog, Wwg, Wog, Wwg, Wwg, Wwg, Ww^Wkf, Ds, Ds, Gll, Gll, Gll, Gll, Gll, Gll, Gll, Gll, Gll, Rb, Rb, Rb, Gll, Gll, Gll, Gll^Qhh, Gll^Qhh, Gll^Qhh, Gll^Qhh, Gll^Qhh, Gll^Qhh, Gll^Qhh, Hhd^Qhh, Hhd, Hhd, Hhd, Hhd, Hhd, Hhd, Md, Md, Md, Md
Wog, Wog, Ds^Qhh, Ds^Qhh, Mv, Ds^Qhh, Wog, Wog, Wog, Wog, Wog, Wog, Wog, Wog, Wog, Wog, Wog, Wog, Wog, Wog, Wog, Wog, Wog, Wog, Wog, Wwg, Wwg, Wwg, Wwg, Ds, Ds, Gll, Gll, Gd, Gll, Gll, Gll, Gll, Rb, Rb, Rb, Gll, Gll, Gll, Gll^Qhh, Gll^Qhh, Hhd^Qhh, Gll^Qhh, Hhd^Qhh, Hhd^Qhh, Hhd^Qhh, Hhd^Qhh, Hhd, Hhd, Hhd, Hhd, Md, Md, Md, Md, Md, Md
Wog, Wog, Ds^Qhh, Khs, Mv, Ds^Qhh, Ds^Qhh, Wog, Wog, Wog, Wog, Wog, Wog, Wog, Wog, Wog, Wog, Wog, Wog, Wog, Wog, Wog, Wog, Wog, Wog, Wwg, Wwg, Wwg, Wwg, Wwg, Ds, Gll, Gd, Gd, Gll, Gll, Rb, Rb, Rb, Rb, Gll^Wm, Rb, Gll, Gll, Gll^Qhh, Hhd^Qhh, Hhd, Hhd^Qhh, Hhd, Hhd, Hhd, Hhd, Hhd, Hhd, Hhd, Hhd^Vhhr, Md, Md, Md, Md, Md, Md
Wog, Wog, Wog, Ds^Qhh, Ds^Qhh, Ds^Qhh, Ds^Qhh, Wog, Wog, Wog, Wog, Wog, Wog, Wog, Wog, Wog, Wog, Wog, Wog, Wog, Wog, Wog, Wog, Wog, Wog, Wog, Wog, Wwg, Wwg, Wwg, Wwg, Ds, Gll, Gd, Gll, Rb, Gll, Gd^Vhr, Rb, Rb, Gll, Rb, Gll, Gll, Gll^Qhh, Hhd^Qhh, Hhd, Hhd, Hhd, Hhd, Hhd, Hhd, Md, Hhd, Md, Md, Md, Md, Md, Md, Md, Md
Wog, Wog, Wog, Wog, Wog, Ds^Qhh, Wog, Wog, Wog, Wog, Wog, Wog, Wog, Wog, Wog, Wog, Wog, Wog, Wog, Wog, Wog, Wog, Wog, Wog, Wog, Wog, Wog, Wog, Wwg, Wwg, Ds, Ds, Gll, Gll, Gll, Gll, Gll, Gll, Rb, Rb, Gll, Gll, Gll^Qhh, Gll^Qhh, Hhd^Qhh, Hhd^Qhh, Hhd, Hhd, Hhd, Hhd, Md, Md, Md, Md, Md, Md, Md, Md, Md, Md, Md, Md
Wog, Wog, Wog, Wog, Wog, Wog, Wog, Wog, Wog, Wog, Wog, Wog, Wog, Wog, Wog, Wog, Wog, Wog, Wog, Wog, Wog, Wog, Wog, Wog, Wog, Wog, Wog, Wog, Wog, Wwg, Ds, Ds, Gll, Gll, Gll, Gll, Rb, Rb, Rb, Rb, Rb, Gll^Qhh, Gll^Qhh, Hhd^Qhh, Hhd^Qhh, Hhd, Hhd, Hhd, Hhd, Hhd, Md, Md, Md, Md, Md, Md, Md, Md, Md, Md, Md, Md
