Gd^Fdf, Gd^Fdf, Gd, Re, Gs, Gd^Fdf, Gd^Fdf, Gd^Fdf, Gd^Fdf, Gd^Fdf, Gd^Fdf, Gd^Fmf, Gd^Fdf, Gd^Fdf, Gd^Fmf, Gd^Fmf, Gd^Fp, Gd^Fp, Gd^Fp, Ww, Ww, Gd^Fp, Gd^Fp, Gs, Gd^Fp, Gd^Fp, Gd^Fp
Gd^Fdf, Gd^Fdf, Gd, Re, Gs^Vl, Gd^Fdf, Gd^Fdf, Gd^Fdf, Gd^Fdf, Gd^Fdf, Gd^Fdf, Gd^Fmf, Gd^Fdf, Gd^Fmf, Gd^Fmf, Gd^Fmf, Gd^Fp, Gd^Fp, Gs^Fp, Ww, Ww, Gd^Fp, Gd^Fp, Gd, Gd^Fp, Gd^Fp, Gd^Fp
Gd^Fdf, Gd^Fdf, Gs^Vl, Re, Re, Gd^Fdf, Gd^Fdf, Gd^Fdf, Gd^Fmf, Gd^Fdf, Gd^Fmf, Gd^Fdf, Gd^Fmf, Gd^Fdf, Gd^Fmf, Gd^Fp, Gd^Fp, Gd^Fp, Gs^Fp, Gs^Fp, Gd^Fp, Ww, Ww, Gd^Fp, Gd^Fp, Gd^Fp, Gd^Fp
Gd^Fdf, Gd^Fdf, Gd^Fdf, Gs, Gd^Fdf, Gd, Gd, Gd^Fdf, Gd^Fdf, Gd^Fmf, Gd^Fdf, Gd^Fmf, Gd^Fdf, Gd^Fmf, Gd^Fdf, Ss, Gd^Fp, Gd^Fp, Gs^Fmf, Gs^Fp, Gd^Fp, Ww, Ww, Gd^Fp, Gd^Fp, Gd^Fp, Gd^Fp
Gd^Fdf, Gd^Fdf, Gd^Fdf, Gd^Fdf, Gd^Fmf, Gd^Fdf, Gd, Gd, Gll^Fmf, Gd^Fmf, Gd^Fdf, Gd^Fmf, Gd^Fmf, Gd^Fmf, Gd^Fmf, Gd^Fmf, Gd^Fdf, Gd^Fmf, Gd^Fmf, Gd^Fp, Gd^Fp, Gd^Fp, Gs^Fp, Ww, Ww, Gd^Fp, Gd^Fp
Gd^Fdf, Gd^Fdf, Gd^Fmf, Gd^Fmf, Ce, Ce, Ce, Gd^Fmf, Gd^Fdf, Gll^Fmf, Gll^Fmf, Gd^Fmf, Gd^Fmf, Gd^Fmf, Gd^Fmf, Ss, Ss, Gd^Fdf, Gd^Fdf, Gd^Fmf, Gd^Fmf, Gs^Fp, Gs^Fp, Ww, Ww, Gd^Fp, Gll^Fp
Gd^Fdf, Gd^Fdf, Gd^Fdf, Gd^Fmf, Ce, Ke, Ce, Gd^Fdf, Gll^Fmf, Gd^Fmf, Gd^Fmf, Gd^Fmf, Gd^Fmf, Gd^Fmf, Gd^Fdf, Ss, Gd^Fdf, Gd^Fdf, Gd^Fmf, Gd^Fmf, Gd^Fp, Gd^Fp, Gd^Fp, Gd^Fp, Ww, Gd^Fp, Gd^Fp
Gd^Fdf, Gd^Fmf, Gd^Fmf, Gd^Fmf, Gd^Fmf, Ce, Gd^Fdf, Gd^Fmf, Gll^Fmf, Gll^Fmf, Gd^Fmf, Gd^Fmf, Gd^Fmf, Gd^Fmf, Gd^Fdf, Gd^Fdf, Ss, Gd^Fmf, Gd^Fdf, Gd^Fmf, Gd^Fmf, Gd^Fp, Gd^Fp, Gd^Fp, Gd^Fp, Ww, Gd
Gd^Fdf, Gd^Fdf, Gd^Fmf, Gd^Fp, Gd^Fp, Gd^Fmf, Gd, Gll^Fmf, Gll^Fmf, Gd^Fmf, Gd^Fmf, Gd^Fmf, Gd^Fmf, Gd^Fmf, Gd^Fp, Ss, Ss, Gd^Fp, Gd^Fp, Gd^Fmf, Gd^Fmf, Gd^Fp, Gd^Fp, Gd^Fp, Gll^Fp, Ww, Ww
Gd^Fdf, Gd^Fdf, Gd^Fmf, Gd^Fp, Gd^Fp, Gd^Fmf, Gll^Fmf, Gd^Fdf, Gd^Fdf, Gs, Gll^Fdf, Gd^Fmf, Gd^Fmf, Gd^Fmf, Ss, Ss, Ss, Ss^Vhs, Gd^Fdf, Gd^Fdf, Gd^Fp, Gd^Fp, Gs, Gll^Fp, Gd^Fp, Ww, Ww
Gd^Fdf, Gd^Fdf, Gd^Fp, Gd^Fp, Gd^Fmf, Gll^Fmf, Gll^Fmf, Gd^Fdf, Gd^Fp, Gd^Fmf, Gll^Fdf, Gll^Fdf, Gd^Fmf, Gd^Fdf, Gd^Fdf, Gd^Fp, Gd^Fdf, Ss, Gd^Fmf, Gd^Fp, Gs, Gd^Fp, Gd^Fp, Gd^Fp, Gd^Fp, Gd^Fp, Ww
Gd^Fmf, Gd^Fmf, Gd^Fdf, Gd^Fp, Gd^Fmf, Gd^Fp, Gd, Gll^Fmf, Gd^Fp, Gd^Fp, Gd^Fp, Gs, Gd^Fmf, Gd^Fmf, Gs, Gd^Fdf, Gd^Fp, Gd^Fmf, Gs, Gd^Fp, Gd^Fp, Gd^Fp, Gs^Fp, Gd^Fp, Gd^Fp, Gd^Fp, Ww
Gd^Fp, Gd^Fmf, Gd^Fmf, Gd^Fmf, Gd^Fmf, Gd^Fmf, Gd, Gd^Fmf, Gd^Fp, Gd^Fp, Gd^Fp, Gd^Fp, Gd^Fp, Gs, Gd^Fmf, Gs, Gs, Gs, Gd^Fp, Gd^Fp, Gd^Fp, Gs^Fp, Gs^Fp, Gs^Fp, Gs^Fp, Ww, Ww
Gd^Fmf, Gd^Fp, Gd^Fp, Gd, Gs, Gd, Gd^Fp, Gd^Fp, Gd^Fp, Gd^Fp, Gd^Fp, Gd^Fmf, Gd^Fdf, Gd^Fmf, Gs^Fet, Gs, Gd^Fp, Gd^Fp, Gs^Fet, Gd^Fp, Gd^Fp, Gs^Fp, Gd^Fp, Gs^Fp, Ww, Ww, Gs^Fp
Gd^Fmf, Gd^Fmf, Gd^Fmf, Gd^Fp, Gll^Fmf, Gd^Fmf, Gd^Fp, Gd^Fp, Gd^Fp, Gd^Fp, Gd^Fmf, Gd^Fmf, Gs^Fet, Gd^Fmf, Ss, Gd, Gd, Ss, Ss, Gd^Fp, Gd^Fp, Gd^Fp, Gd^Fp, Gd^Fp, Ww, Gs^Fp, Gs^Fp
Gd^Fmf, Gd^Fmf, Gd^Fp, Gd^Fmf, Gll^Fmf, Gd^Fp, Gd^Fp, Gd^Fp, Gd^Fmf, Gd^Fmf, Gd^Fmf, Gd^Fdf, Gd^Fdf, Ss, Ss, Gs^Fet, Gd, Gs^Fet, Ss, Gs^Fet, Gd^Fp, Gd^Fp, Gd^Fp, Gd^Fp, Ww, Gs^Fp, Gd^Fp
Gd^Fp, Gd^Fp, Gll^Fmf, Gd^Fp, Gll^Fmf, Gd^Fp, Gd^Fp, Gd^Fp, Gd^Fmf, Gd^Fdf, Gd^Fdf, Gd^Fdf, Gs^Fet, Ss, Ss, Ch, Kh, Ch, Ss, Ss, Gs^Fet, Gd^Fp, Gs^Fp, Gd^Fp, Ww, Gs^Fp, Gs^Fp
Gd^Fp, Gd^Fp, Gd^Fp, Gll^Fmf, Gll^Fmf, Gd^Fp, Gd^Fp, Gd^Fp, Gd^Fmf, Gd^Fdf, Gd^Fmf, Gd^Fdf, Gd^Fdf, Gd^Fdf, Ss, Ch, Gs^Fet, Ch, Ss, Ss, Gd^Fdf, Gd^Fp, Gs^Fmf, Gs^Fp, Ww, Gd^Fp, Gd^Fp
Ww, Ww, Ww, Gs, Gd^Fp, Gd^Fp, Ww, Gd^Fp, Ww, Gd^Fmf, Gd^Fmf, Gd^Fdf, Gd^Fdf, Gs^Fet, Ss, Ss, Ss, Ss, Gd^Fdf, Gs^Fet, Gd^Fdf, Gs^Fmf, Gs^Fp, Gs^Fp, Ww, Gd^Fp, Gs^Fp
Gs^Fp, Gs^Fp, Gd^Fp, Ww, Ww, Ww, Ww, Ww, Gd^Fp, Ww, Ww, Gd^Fdf, Ss, Ss, Gs^Fet, Ss, Gd^Fdf, Gs^Fet, Gd^Fdf, Gd^Fdf, Gd^Fdf, Gd^Fmf, Gd^Fmf, Gd^Fp, Ww, Ww, Ww
Gs^Fp, Gs^Fp, Gd^Fp, Gs, Gs, Gs^Fp, Gd^Fp, Gs^Fp, Gd^Fp, Gd^Fp, Gs^Fp, Ww, Ww, Ss, Ss, Ss, Gd^Fmf, Gd^Fdf, Gd^Fdf, Gd^Fdf, Gd^Fmf, Hh^Fmf, Hh^Fmf, Gd^Fp, Gd^Fp, Ww, Ww
Gd^Fp, Gd^Fp, Gd^Fp, Gd^Fp, Gs, Gd^Fp, Gll^Fp, Gd^Fp, Gd^Fp, Gd^Fp, Gd^Fp, Gs^Fp, Gs^Fp, Ww, Ss, Gd^Fmf, Gd^Fdf, Gd^Fdf, Gd^Fmf, Gd^Fmf, Gd^Fp, Hh^Fmf, Hh, Gd^Fp, Hh^Fp, Gd^Fp, Gd
Gd^Fp, Gd^Fp, Gd^Fp, Gd^Fp, Gd^Fp, Gs, Gll^Fp, Gd^Fp, Gd^Fp, Gs^Fp, Gs^Fp, Gd^Fp, Gs^Fp, Ww, Ww, Gd^Fmf, Gd^Fmf, Gd^Fdf, Gd^Fmf, Gd^Fmf, Gd^Fp, Hh, Gd, Gd, Hh, Hh^Fp, Gd
Gd^Fp, Gd^Fp, Gs^Fp, Gs^Fp, Gd^Fp, Gd^Fp, Gll^Fp, Gd^Fp, Gd^Fp, Gs^Fp, Gs^Fp, Gs^Fp, Gs^Fp, Gs^Fp, Gs^Fp, Ww, Ww, Ww, Ww, Gd^Fp, Gd^Fmf, Gd^Fp, Hh^Fp, Hh, Hh^Fp, Gd^Fp, Gd^Fp
Gd^Fp, Gd^Fp, Gs^Fp, Gs^Fp, Gd^Fp, Gd^Fp, Gd, Gd^Fp, Gd^Fp, Gd^Fp, Gd^Fp, Gs^Fp, Gd^Fp, Gs^Fp, Gs^Fp, Gd^Fp, Gd^Fp, Gd^Fp, Ww, Ww, Ww, Gd^Fp, Ww, Hh^Fp, Gd^Fp, Gd^Fp, Gd
Gd^Fp, Gs^Fp, Gs^Fp, Gs^Fp, Gs^Fp, Gd^Fp, Gd^Fp, Gd, Gd, Gd^Fp, Gs^Fp, Gd^Fp, Gd^Fp, Gd^Fp, Gd^Fp, Gd^Fp, Gd^Fp, Gd^Fp, Gd^Fp, Gs^Fp, Gs^Fp, Ww, Ww, Ww, Ww, Ww, Ww
