Gll^Qhuf, Gll^Fp, Gll^Qhuf, Gll^Qhuf, Gll^Qhuf, Gll^Qhu, Aa^Qhu, Aa^Qhh, Aa^Qhh, Gll^Qhh, Aa^Qhu, Gll^Qhu, Gll^Eqp, Gll^Eqp, Gll^Eqp, Gll^Qhu, Gll^Qhu, Gll^Qhh, Aa^Qhh, Aa^Qhh, Aa^Qhh, Aa^Qhh, Aa^Qhh, Aa^Qhh, Aa^Qhu, Gll^Qhu, Gll^Eqp, Gll^Qhu, Gll^Qhu, Gll^Qhu, Gll^Eqp, Gll^Eqp, Gll^Eqp, Gll^Qhu, Gd^Qhu, Gll^Qhh, Gd^Qhh, Gll^Qhh, Aa^Qhh, Aa^Qhh, Aa^Fpa, Gd^_mh
Gll^Qhuf, Gll^Qhuf, Gll^Qhuf, Gll^Qhuf, Gll^Fp, Gll^Qhuf, Aa^Eqp, Aa^Qhu, Aa^Qhu, Aa^Qhu, Aa^Eqp, Gll^Eqp, Gs^Vht, Gll, Gll, Gll^Eqp, Gll^Eqp, Aa^Qhu, Aa^Qhu, Aa^Qhh, Aa^Qhh, Aa^Qhh, Aa^Qhu, Aa^Qhu, Gll^Eqp, Gll^Eqp, Gll, Gll^Eqp, Gll^Eqp, Gll^Eqp, Aa, Gll, Gll, Gll^Eqp, Gll^Eqp, Gd^Qhu, Gd^Qhu, Gll^Qhh, Aa^Qhh, Aa^Qhh, Aa^Fpa, Aa^Fpa
Gll^Qhuf, Gll^Qhuf, Gll^Fp, Gll^Qhuf, Gd^Eqp, Gd^Eqp, Aa, Aa^Eqp, Aa^Eqp, Aa^Eqp, Aa, Gll, Rb, Gd, Gd, Gll, Gd, Gll^Eqp, Gll^Eqp, Gll^Qhu, Gll^Qhu, Gll^Qhu, Gll^Eqp, Gll^Eqp, Gll, Gll, Gs^Vht, Gll, Gll, Aa, Aa, Gll, Aa, Aa, Gll, Gll^Eqp, Gd^Eqp, Gll^Qhu, Aa^Qhu, Aa^Qhh, Aa^Qhh, Aa^_mh
Gll^Qhu, Gll^Fp, Gd^Eqp, Gd^Eqp, Gd, Gd, Gll, Aa, Gd, Aa, Aa, Gll, Rb, Gll, Gll^Efm, Gll, Gll, Gd^Efm, Gll, Gll^Eqp, Gll^Eqp, Gll^Eqp, Gll, Gll^Ecf, Rb, Gll, Rb, Gll, Gll^Eff, Gll^Eff, Gll^Eff, Aa, Gll, Gll, Rb, Gd^Vo, Gll, Gll^Eqp, Gll^Eqp, Aa^Qhu, Aa^Qhu, Aa^_mh
Gll^Eqp, Gll^Eqp, Gll, Gs^Vht, Rb, Gll, Gll^Ecf, Gd, Gll, Gd, Gd, Gll, Rb, Gll, Gll, Gg^Vwm, Gll^Qhh, Gll, Rb, Rb, Rb, Rb, Rb, Rb, Gll, Rb, Gll^Fp, Gd^Eff, Rb^Gvs, Rb^Gvs, Rb^Gvs, Gll^Eff, Rb, Rb, Gll, Gll, Gd^Efm, Gd, Gll, Gll^Eqp, Gll^Eqp, Gll^Qhu
Gll, Gll, Aa, Gll, Rb, Rb, Rb, Gll, Gll, Gd, Gd, Gll, Rb, Gll, Gll^Qhh, Gll^Qhh, Exos, Gll^Qhh, Rb^Qhh, Gll, Gd, Gll, Gll, Gll, Aa, Aa, Gll^Fp, Gd^Eff, Gd^Eff, Rb^Gvs, Gd^Eff, Gd^Eff, Rb, Gll, Gll^Efm, Gll^Efm, Gd, Gd, Gd, Gll, Gd, Gll^Eqp
Gll^Qhh, Aa, Aa, Aa^Voa, Gd, Gll, Gll, Rb, Rb, Gll, Rb, Gll, Gll, Rb, Gll^Qhh, Exos, Exos, Exos, Exos, Gll^Qhh, Gd^Qhh, Gd, Gll, Aa, Aa, Aa, Gll^Fp, Gll^Fp, Gll^Fp, Gd, Gll, Gll, Rb, Gll, Gll, Gll^Wm, Gll, Gll^Ecf, Gll, Gd^Vo, Rb, Gll
Gll^Qhh, Gll^Qhh, Gll^Qhh, Aa, Gd, Gd, Gll, Gll, Rb, Rb, Gll, Rb, Rb, Rb, Rb^Qhh, Exos, Exos, Exos, Exos, Exos, Exos, Gll^Qhh, Gll^Qhh, Aa, Aa, Aa, Aa, Aa, Aa, Gll^Fp, Gll, Gll, Rb, Gll, Rb, Gll, Rb, Rb, Rb, Rb, Gll, Gll
Gll, Gll^Qhh, Gll^Efm, Gll^Qhh, Gll^Qhh, Gd^Qhh, Gll, Rb, Gll, Gll, Gll^Eff, Gll, Gll^Wm, Gll, Aa^Qhh, Exos, Exos, Rb^Ecf, Exos^_mh, Exos, Exos, Exos, Rb^Qhh, Gll, Gll, Aa, Gll, Aa, Aa, Gll, Gll, Rb, Rb, Rb, Gll, Rb, Gll, Gll, Aa, Gll, Gll, Gll
Gll, Gll^Efm, Gll, Gll, Rb, Gll^Qhh, Rb, Rb, Gll^Eff, Gll^Eff, Rb^Gvs, Gll^Eff, Aa^Eff, Aa, Aa, Aa^Qhh, Exos, Exos, Exos, Exos, Exos, Exos, Gll^Qhh, Rb, Rb, Gll, Rb, Gll, Gll, Aa, Gll, Rb, Gll, Gll^Efm, Gll, Gll, Gll, Aa, Aa, Aa, Gll, Gll
Gll, Gll^Efm, Gd^Efm, Rb, Gll, Rb^Qhh, Gll^Eff, Gll^Eff, Rb^Gvs, Rb^Gvs, Rb^Gvs, Rb^Gvs, Gll^Eff, Gll^Eff, Gll, Rb^Qhh, Gll^Qhh, Exos, Exos, Exos, Gll^Qhh, Gll^Qhh, Gd, Gll, Gll, Rb, Gll, Rb, Rb, Gll, Gll, Rb, Gll, Gll^Efm, Gll^Efm, Gll^Efm, Aa, Aa, Aa, Aa, Aa, Gll
Gll, Gll, Gll, Gs^Vht, Gll, Gll^Qhh, Gd, Gd^Eff, Gd^Eff, Rb^Gvs, Gd^Eff, Gll^Eff, Gll, Gll, Rb, Rb, Gd, Gll^Qhh, Gll^Qhh, Gll^Qhh, Gll, Gll, Gd^Efm, Gd^Efm, Gd^Qhu, Gll^Efm, Gll^Efm, Gll, Gll, Rb, Rb, Rb, Gll, Gll, Gll, Aa, Aa, Aa, Aa, Aa, Aa^Eqp, Gll^Eqp
Gll, Gll, Aa, Gll, Aa, Aa^Qhh, Gll^Qhh, Gll, Gll, Gd^Eff, Rb, Gll, Rb, Rb, Rb, Gll, Gd, Gd, Gd, Gll, Gs^Vht, Gll, Gll^Qhu, Gll^Qhu, Gll^Ecf, Gll^Qhu, Gll^Qhu, Gll, Gll, Rb, Rb, Rb, Gll, Gll, Gll, Gll, Gll, Gll, Gd^Eqp, Gll^Eqp, Gll^Qhu, Aa^Qhu
Aa^Qhh, Aa^Qhh, Aa^Qhh, Aa^Qhh, Aa^Qhh, Gll^Qhh, Gll^Qhh, Gll^Qhh, Rb^Qhh, Rb, Gll, Rb, Gll, Gll, Gll, Rb, Rb, Gd, Gll, Gll, Gll, Rb^Qhu, Rb, Rb, Rb, Rb, Rb, Gll^Qhu, Rb^Qhu, Gll, Gg^Vwm, Rb, Rb, Gll, Rb, Exos, Exos^Ebn, Gd^Eqp, Gd^Qhu, Gd^Qhu, Gd^_ml, Gll
Aa, Aa, Aa, Aa, Gll^_mh, Gll, Gll, Gll^Ecf, Rb^Qhh, Gll, Gll^Fp, Gll^Fp, Gll^Fp, Gll^Efm, Gll^Efm, Gll, Gll, Rb, Gll^Ecf, Gll, Gll, Gll^Qhu, Gll, Gll, Gll, Gll, Rb, Rb, Gll^Qhu, Rb, Rb, Rb, Rb, Rb, Rb, Rb, Rb, Gd^Qhu, Gll^Qhu, Gll, Gll, Gll
Aa, Aa, Aa, Aa, Gll, Gll, Gs^Vht, Rb, Gll^Qhh, Gll, Gll^Fp, Gll^Fp, Gll^Fp, Gll, Gll^Efm, Gll^Efm, Gll, Rb, Gll, Gll, Gll, Gll^Qhu, Gd^Qhu, Gs^Vht, Rb, Gll^_ml, Rb, Gll^Qhu, Gll, Gll, Gll, Gll, Gll, Rb, Exos, Rb, Rb, Rb, Rb, Gll^Qhu, Gll^Qhu, Gll
Gll^Fp, Gll, Gll^Fp, Gll^Fp, Gll^Fp, Gll, Gd, Gll, Gll^Qhh, Gll, Gd, Gll^Fp, Gd^Efm, Gd, Gll, Gll, Gll, Rb, Aa^Voa, Aa, Aa, Gll, Gll^Qhu, Rb, Rb, Gll, Rb, Gll^Qhu, Gll, Gd, Gll, Gll, Gd, Gll, Gll, Exos, Exos^Ebn, Rb, Rb, Rb, Rb, Gll^Qhu
Gll^Fp, Gll^Fp, Gll^Fp, Gll^Fp, Gll^Fp, Gll^Fp, Gll^Fp, Gll, Gll, Gll^Qhh, Gll, Gll^Efm, Gll, Gll, Gll, Gll, Gll, Gll, Aa, Aa, Aa, Gll, Gll, Gll^Qhu, Gll^Qhu, Rb, Gll^Qhu, Gll^Qhu, Gd, Gd, Gd, Gll, Gd, Gll, Gll^Eqp, Gll^Eqp, Gll^Qhu, Rb, Rb, Rb, Rb, Gll^Qhu
Gll^Fp, Gll^Fp, Gll^Fp, Gll^Fp, Gll^Fp, Gll^Fp, Gll^Fp, Gll^Fp, Gll, Gll^Qhh, Gll^Qhh, Gll, Gll, Gll, Gll, Gll, Gll, Aa, Aa, Aa, Aa, Aa, Aa, Aa, Gll, Gll^Qhu, Gll, Gll, Gll, Gll, Gd, Gd, Gll^Eqp, Gll^Eqp, Gll^Qhu, Gll^Qhu, Gll^Qhu, Gll^Qhu, Rb, Rb, Rb, Rb
