Mm, Mm, Mm, Mm, Mm, Mm, Mm, Mm, Ww, Mm, Mm, Mm, Mm, Mm, Hh, Mm, Mm, Mm, Mm, Mm, Mm, Hh, Hh, Hh, Gll, Gll, Rr, Rr, Gll, Gll, Gll, Hh, Hh, Hh, Hh, Hh, Hh
Mm, Mm, Mm, Mm, Mm, Mm, Mm, Mm, Ww, Mm, Mm, Mm, Mm, Mm, Hh, Mm, Mm, Mm, Mm, Mm, Mm, Hh, Hh, Ke, Ce, Ce, Rr, Rr, Gll, Gll, Gll, Hh, Hh, Hh, Hh, Hh, Hh
Hh, Hh, Hh, Mm, Mm, Mm, Mm, Ww, Mm, Mm, Mm, Mm, Mm, Mm, Hh^Vhh, Mm, Mm, Mm, Mm, Mm, Mm, Hh, Hh, Ce, Ce, Ce, Rr, Gll, Ww, Gs^Vh, Hh, Hh, Hh, Hh, Mm, Mm, Mm
Hh, Hh, Hh, Hh, Hh, Mm, Mm, Mm, Mm, Mm, Mm, Mm, Ww, Ww, Mm, Mm, Mm, Mm, Mm, Mm, Hh, Hh, Hh, Hh, Gs^Vh, Ce, Rr, Ww, Ww, Ww, Hh, Hh, Hh, Mm, Mm, Mm, Mm
Hh, Hh, Hh, Hh, Hh, Hh, Hh, Hh, Hh, Hh, Ww, Ww, Hh, Mm, Mm, Mm, Mm, Mm, Hh, Hh, Hh, Hh, Hh, Hh, Rr, Rr, Hh, Hh, Hh, Hh, Hh, Hh, Mm, Mm, Mm, Mm, Mm
Gll, Gll, Hh, Hh, Hh^Vhh, Hh, Hh, Hh, Hh, Ww, Gll, Gll, Hh, Mm, Mm, Mm, Mm, Mm, Hh, Hh, Gll, Hh, Gll, Gll, Rr, Hh, Hh, Hh, Hh, Hh, Hh, Mm, Mm, Mm, Mm, Mm, Mm
Gll^Fmw, Gll^Fmw, Gll^Fmw, Hh, Hh, Hh, Hh, Hh, Ww, Ww^Bw\, Hh, Hh, Hh, Mm, Mm, Mm, Mm, Mm, Hh, Gll, Gll, Hh, Gll, Rr, Hh, Hh, Hh, Hh, Hh, Hh, Hh, Mm, Mm, Mm, Mm, Mm, Mm
Gll^Fmw, Gll^Fmw, Gll^Fmw, Gll^Fmw, Gll^Fmw, Gll^Fdf, Gll^Fdf, Gll, Ww, Gll, Gll, Hh, Hh, Hh, Hh, Mm, Mm, Hh, Cer, Hh, Gll, Gll, Rr, Rr, Gll^Fmf, Gll, Hh, Hh, Hh, Hh, Hh, Mm, Mm, Mm, Hh^Vhh, Mm, Mm
Gll^Fmw, Gll^Fmw, Gll^Fmf, Gll^Fmf, Gll^Fmf, Gll^Fmf, Ww, Ww, Ww, Ww, Gll, Hh, Gll, Hh, Hh, Mm, Mm, Cer, Cer, Cer, Rr, Rr, Gd^Vhr, Gll^Fmw, Gll^Fmw, Gll^Fmf, Gll, Hh, Hh, Hh, Hh, Hh, Mm, Ww, Ww, Ww, Ww
Gll^Fmw, Gll^Fmf, Gll^Fmf, Gll^Fmf, Ww, Ww, Gll^Fdf, Gll, Gll, Ww, Gll, Gll, Gs^Vh, Gll, Ww, Mm, Gll^Fmf, Ker, Gll^Fmf, Cer, Rr, Gll, Gll, Gll^Fmw, Gll^Fmf, Gll^Fmf, Gll^Fmf, Gll, Gll^Fdf, Hh, Hh, Hh, Ww, Ww, Mm, Mm, Mm
Gll^Fmw, Gll^Fmf, Gll^Fdf, Ww, Ce, Gll^Fdf, Gll, Gll, Ww, Ww, Ww, Gll, Ww, Ww, Gll, Gll^Fmf, Gll^Fmf, Gll^Fmf, Gll^Fmf, Rr, Gll, Gll, Hh, Hh, Hh, Hh, Hh, Gll^Fmf, Gll^Fmf, Gll^Fdf, Ww, Ww^Bw\, Hh, Hh, Hh, Mm, Mm
Gll^Fmf, Gll^Fmf, Gll^Fdf, Ce, Ke, Ce, Gll, Ww, Ww, Wo, Wo, Ww, Gll, Gll, Gll, Gll, Gd^Vhr, Gll^Fmf, Rr, Rr, Gll, Hh, Hh, Hh, Hh, Hh, Hh, Gll^Fdf, Gll^Fdf, Gll^Fdf, Ww, Hh, Cer, Cer, Hh, Hh, Hh
Gll^Fmw, Gll^Fmf, Gll, Ce, Ce, Re, Re, Gs^Vh, Ww, Ww, Ww, Ww, Gll, Gll, Gll, Gll, Rr, Rr, Gll, Gll, Gll, Gll, Hh, Hh, Hh, Hh, Gll, Gll, Gll, Ww, Hh, Hh, Cer, Ker, Hh, Hh, Hh
Gll, Gll, Gll, Gll, Ww, Ww, Ww, Ww^Bw\, Gll, Gll, Gll, Ww, Gll, Gll, Gll, Gll, Rr, Rr, Rr, Gll, Gll, Hh, Hh, Gd^Vhr, Ww, Gll, Gll, Gll, Ww, Ww, Hh, Hh, Hh, Hh, Hh, Hh, Hh
Gll, Gll, Gll, Ww, Gll, Gll, Gll, Re, Re, Gll, Gll, Gll, Re, Gll, Re, Rr, Gll, Gll, Rr, Gll, Gll, Gll, Gll, Ww, Ww, Gll, Gd^Vhr, Gll^Fdf, Ww, Ww, Ww, Hh, Hh, Hh, Ww, Gll, Gll
Gll, Gll, Ww, Ww, Gll, Gll, Gll, Gll, Gll, Re, Re, Re, Gd^Vhr, Re, Gll, Gll, Gll^Fdf, Gll, Re, Gd^Vhr, Gll, Gll, Ww, Ww, Wo, Ww, Ww, Ww, Gll^Fdf, Ww, Gll^Fmf, Ww, Ww, Ww, Gll^Fmf, Gll, Gll
Ww, Ww, Gll, Gll, Gll, Gll, Gll, Gll, Gll, Gll, Gll, Gll, Hh, Hh, Hh, Gll^Fdf, Gll^Fmf, Gll^Fdf, Re, Gll, Gll, Gll, Ww, Wo, Wo, Wo, Ww, Gll, Gll, Gll^Fdf, Gll^Fdf, Gll^Fmf, Gll^Fmf, Gll^Fmf, Gll^Fmf, Gll^Fmf, Gll^Fmf
Gll, Gll, Gll^Fmf, Gll^Fmf, Gll^Fmf, Gll, Gll, Gll, Gll, Gll, Gll, Gll, Hh, Hh, Hh, Gll^Fmf, Gll^Fmf, Gll^Fdf, Re, Gll, Gll, Ww, Gd^Vhr, Ww, Ww, Ww, Gll, Gll, Gll, Gll^Fdf, Gll^Fmf, Gll^Fdf, Gll^Fmf, Gll^Fmf, Gll^Fmf, Gll^Fmf, Gll^Fmf
Gll, Gll, Gll^Fmf, Gll^Fmf, Gll^Fmf, Gll^Fmf, Gll^Fmf, Gll, Gll, Gll, Hh, Hh, Hh, Hh, Gll^Fmf, Gll^Fmf, Gll^Fmf, Gll^Fdf, Re, Gll, Gll, Gll, Gll, Gll, Gll, Ww, Gd^Vhr, Gll, Gll, Gll^Fmf, Gll^Fmf, Gll^Fmf, Gll^Fmf, Gd^Vhr, Gll^Fmf, Gll^Fmf, Gll^Fmf
Gll, Gll, Gll^Fmf, Gll^Fmf, Gll^Fmf, Gll^Fmf, Gll^Fmf, Gd^Vhr, Gll, Hh, Hh, Hh, Ww, Hh, Gll^Fmf, Gll^Fmf, Gll^Fmf, Gll^Fdf, Re, Gll, Gll, Gll, Gll, Gll, Gll, Ww^Bw/, Gll, Gll, Gll, Gll, Gll, Gll^Fmf, Gll^Fmf, Gll^Fmf, Ww, Gll^Fmf, Gll^Fmf
Gll, Gll, Gll^Fmf, Gll^Fmf, Gll^Fmf, Gll^Fmf, Gll^Fmf, Gll^Fmf, Gll^Fmf, Hh, Hh, Hh, Hh, Hh, Hh, Gll^Fmf, Gll^Fdf, Gll^Fdf, Re, Gll, Gll^Fdf, Gll^Fdf, Gll^Fdf, Gll, Gll, Ww, Gll, Gll^Fdf, Gll^Fdf, Gll, Gll, Gll^Fmf, Gll^Fmf, Ww, Ww, Gll, Gll
Gll^Fmf, Gll^Fmf, Gll^Fmf, Gll^Fmf, Gll^Fmf, Gd^Vhr, Gll^Fmf, Gll^Fmf, Gll^Fmf, Gll, Gll, Gll, Gll, Hh, Hh, Gll, Gll, Gll, Re, Gll, Gll^Fdf, Gll^Fdf, Gll^Fdf, Gll, Gll, Ww, Ww, Gll^Fdf, Gll^Fdf, Gd^Vhr, Gll, Gll, Ww, Ww, Ww, Gll, Gll
Gll^Fmf, Gll^Fmf, Gll^Fdf, Gll^Fmf, Gll^Fmf, Gll^Fmf, Gll, Gll^Fmf, Gll, Gll, Gll, Gll, Hh, Hh, Hh, Gll, Gll, Gll, Re, Gll, Gll^Fdf, Gll^Fdf, Re, Gll^Fdf, Gd^Vhr, Ww, Ww, Ww, Ww, Gll, Ww, Ww, Gll, Gll, Gll, Gll, Gll
Gll^Fdf, Gll^Fdf, Ww, Gll^Fdf, Gll^Fmf, Gll^Fmf, Gll, Gll, Gll, Ww, Ww, Gll, Gll, Hh, Gll^Fdf, Gll^Fdf, Gll^Fdf, Gll, Gll, Re, Re, Re, Gll^Fdf, Re, Re, Gll, Gll, Gll, Ww, Ww, Re, Gll, Cer, Cer, Cer, Gll, Gll
Gll^Fdf, Gll^Fdf, Ww, Ww, Ww, Gll, Gd^Vhr, Gll, Gll, Ww, Ww, Gll, Gll^Fdf, Gll^Fdf, Gll^Fdf, Gll^Fdf, Gll^Fdf, Gll^Fdf, Gll, Re, Gll, Gll^Fdf, Gll^Fdf, Gll^Fdf, Gll, Re, Re, Gll, Ww, Ww, Gd^Vhr, Re, Cer, Ker, Cer, Gll, Gll
Gll^Fdf, Gll^Fdf, Gll^Fdf, Gll^Fdf, Ww, Gll, Gll, Gll, Gll, Gll, Gll, Gll, Cer, Gll^Fdf, Gll^Fdf, Gll^Fdf, Gll^Fdf, Gll^Fdf, Gll, Re, Gd^Vhr, Gll^Fdf, Gll^Fdf, Gll^Fdf, Gll^Fdf, Gll^Fdf, Re, Gll, Gll, Ww, Ww^Bw/, Re, Gll, Cer, Gll, Gll, Gll
Gll^Fdf, Gll^Fdf, Gll^Fdf, Gll^Fdf, Ww, Gll, Hh, Hh, Hh, Cer, Ker, Cer, Cer, Gll^Fdf, Gll^Fdf, Gll^Fdf, Gll^Fdf, Gll^Fdf, Gll, Re, Gll, Gll^Fdf, Gll^Fdf, Gll^Fdf, Gll^Fdf, Gll^Fdf, Gll^Fdf, Re, Re, Re, Ww, Ww, Ww, Gll, Ww, Gll, Gll
Gll^Fdf, Gll^Fdf, Gll^Fdf, Ww, Ww, Hh, Hh, Hh, Hh, Cer, Hh, Cer, Gll, Gll, Gll, Gll^Fdf, Gll^Fdf, Gll^Fdf, Gll, Re, Gll, Gll, Gll^Fdf, Gll^Fdf, Gll^Fdf, Gll^Fdf, Gll, Gll, Gll, Gd^Vhr, Ww, Ww, Ww, Ww, Ww, Ww, Ww
Gll^Fdf, Gll^Fdf, Gll^Fdf, Gll^Fdf, Ww, Hh, Hh, Hh, Hh, Hh, Hh, Hh, Hh, Gd^Vhr, Hh, Hh, Hh, Gll, Re, Re, Gll^Fdf, Gll^Fdf, Gll^Fdf, Gll^Fdf, Gll^Fdf, Gll, Ww, Gll, Gll, Gll, Ww, Ww, Ww, Ww, Ww, Ww, Ww
Gll^Fdf, Gll^Fdf, Gll^Fdf, Gll^Fdf, Ww, Gll, Ww, Ww, Ww^Bw|r, Hh, Ww, Hh, Hh, Hh, Hh, Hh, Hh, Gll, Re, Gll, Gll^Fdf, Gll^Fdf, Gll^Fdf, Gll^Fdf, Gll, Ww, Ww, Ww, Ww, Ww, Ww, Ww, Wo, Wo, Wo, Wo, Wo
Gll^Fdf, Gll^Fdf, Gll^Fdf, Ww, Wo, Ww, Ww, Ww, Gd^Vhr, Ww, Hh, Ww, Hh, Hh, Gll, Hh, Gll, Gll, Re, Gll, Gll, Gll^Fdf, Gll^Fdf, Gll^Fdf, Gll, Ww, Ww, Ww, Ww, Ww, Wo, Ww, Wo, Wo, Wo, Wo, Wo
Gll^Fdf, Gll^Fdf, Gll^Fdf, Ww, Ww, Wo, Ww, Gll, Hh, Hh, Mm, Hh, Hh, Hh, Re, Gll, Re, Re, Hh, Gd^Vhr, Gll, Gll, Ww, Gll, Ww, Ww, Ww, Ww, Wo, Ww, Wo, Wo, Wo, Wo, Wo, Wo, Wo
Gll^Fdf, Gll^Fdf, Gll^Fdf, Gll^Fdf, Ww, Ww, Hh, Hh, Mm, Mm, Mm, Mm, Mm, Mm, Re, Re, Hh, Hh, Hh, Hh, Gll, Ww, Gll, Ww, Gll, Ww, Ww, Wo, Wo, Wo, Wo, Wo, Wo, Wo, Wo, Wo, Wo
Gll^Fdf, Gll^Fdf, Gll, Gll^Fdf, Ww, Hh, Hh, Hh, Hh, Hh, Mm, Mm, Hh, Re, Mm, Hh, Hh, Hh, Gll, Gll, Gll^Fdf, Gll^Fdf, Gll^Fdf, Gll, Gll, Ww, Ww, Wo, Wo, Wo, Wo, Wo, Wo, Wo, Wo, Wo, Wo
Gll, Gll, Gll, Gll, Ww, Hh, Hh, Hh, Hh, Mm, Mm, Mm, Mm, Re, Mm, Hh, Hh, Hh, Hh, Gll, Gll^Fdf, Gll, Gll^Fdf, Gd^Vhr, Ww, Ww, Ww, Ww, Wo, Wo, Wo, Wo, Wo, Wo, Wo, Wo, Wo
Gll, Gll, Gd^Vhr, Gll, Ww, Hh, Hh, Hh, Mm, Mm, Mm, Mm, Cud, Re, Mm, Hh, Hh, Hh, Hh, Gll^Fdf, Gll^Fdf, Gll^Fdf, Gll^Fdf, Gll, Ww, Ww, Ww, Ww, Wo, Wo, Wo, Wo, Wo, Wo, Wo, Wo, Wo
Ww, Ww, Ww, Ww, Gll, Gll, Hh, Hh, Mm, Mm, Mm, Cud, Kud, Cud, Mm, Mm, Hh, Hh, Gd^Vhr, Hh, Gll, Gll^Fdf, Ww, Ww, Ww, Ww, Ww, Wo, Wo, Wo, Wo, Wo, Wo, Wo, Wo, Wo, Wo
Ww, Ww, Ww, Ww, Gll, Gll, Gll, Hh, Hh, Mm, Mm, Cud, Cud, Cud, Mm, Mm, Hh, Hh, Hh, Hh, Gll, Gll, Ww, Ww, Wo, Ww, Wo, Wo, Wo, Wo, Wo, Wo, Wo, Wo, Wo, Wo, Wo
Ww, Ww, Ww, Ww, Ww, Gll, Gll, Hh, Hh, Hh, Hh, Mm, Mm, Mm, Mm, Mm, Hh, Hh, Hh, Gll, Gll, Gll, Ww, Ww, Ww, Wo, Wo, Wo, Wo, Wo, Wo, Wo, Wo, Wo, Wo, Wo, Wo
Wo, Wo, Ww, Ww, Ww, Gll, Gll, Gll, Hh, Hh, Hh, Hh, Hh, Hh, Gd^Vhr, Hh, Gll, Hh, Gll, Gll, Ww, Ww, Ww, Ww, Ww, Wo, Wo, Wo, Wo, Wo, Wo, Wo, Wo, Wo, Wo, Wo, Wo
Wo, Wo, Ww, Ww, Ww, Ww, Gll, Gll, Gll, Hh, Hh, Hh, Gll, Gll^Fdf, Gll^Fdf, Gll^Fdf, Gll^Fdf, Gll, Gll, Gll, Ww, Ww, Ww, Ww, Wo, Wo, Wo, Wo, Wo, Wo, Wo, Wo, Wo, Wo, Wo, Wo, Wo
Wo, Wo, Wo, Wo, Ww, Ww, Ww, Gll, Ww, Gll, Gd^Vhr, Gll, Gll, Gll^Fdf, Gll^Fdf, Gll^Fdf, Gll^Fdf, Gll^Fdf, Gll, Ww, Ww, Ww, Ww, Wo, Wo, Wo, Wo, Wo, Wo, Wo, Wo, Wo, Wo, Wo, Wo, Wo, Wo
Wo, Wo, Wo, Wo, Wo, Ww, Ww, Ww, Ww, Gll, Gll, Gll, Ww, Gll, Ww, Gll, Ww, Gll, Ww, Ww, Ww, Ww, Wo, Wo, Wo, Wo, Wo, Wo, Wo, Wo, Wo, Wo, Wo, Wo, Wo, Wo, Wo
Wo, Wo, Wo, Wo, Wo, Wo, Ww, Ww, Ww, Ww, Ww, Ww, Ww, Ww, Ww, Ww, Ww, Ww, Ww, Ww, Ww, Ww, Wo, Wo, Wo, Wo, Wo, Wo, Wo, Wo, Wo, Wo, Wo, Wo, Wo, Wo, Wo
Wo, Wo, Wo, Wo, Wo, Ww, Ww, Ww, Ww, Ww, Ww, Ww, Ww, Ww, Wo, Ww, Ww, Ww, Ww, Ww, Ww, Ww, Wo, Wo, Wo, Wo, Wo, Wo, Wo, Wo, Wo, Wo, Wo, Wo, Wo, Wo, Wo
Wo, Wo, Wo, Wo, Wo, Wo, Wo, Wo, Wo, Ww, Wo, Ww, Wo, Wo, Wo, Ww, Wo, Ww, Wo, Wo, Wo, Wo, Wo, Wo, Wo, Wo, Wo, Wo, Wo, Wo, Wo, Wo, Wo, Wo, Wo, Wo, Wo
Wo, Wo, Wo, Wo, Wo, Wo, Wo, Wo, Wo, Wo, Wo, Wo, Wo, Wo, Wo, Wo, Wo, Wo, Wo, Wo, Wo, Wo, Wo, Wo, Wo, Wo, Wo, Wo, Wo, Wo, Wo, Wo, Wo, Wo, Wo, Wo, Wo
