Xoc, Xoc, Xoc, Xoc, Xoc, Xoc, Xoc, Xoc, Xoc, Xoc, Xoc, Xoc, Xoc, Xoc, Xoc, Xoc, Xoc, Xoc, Xoc, Xoc, Xoc, Xoc, Xoc, Xoc, Xoc, Xoc, Xoc, Xoc, Xoc, Xoc, Xoc, Xoc, Xoc, Xoc, Xoc, Xoc, Xoc
Xoc, Xoc, Xoc, Xoc, Xoc, Xoc, Xoc, Xoc, Xoc, Xoc, Xoc, Xoc, Xoc, Xoc, Xoi, Xoi, Xoi, Xoi, Xoi, Xoc, Xoc, Xoc, Xoc, Xoc, Xoc, Xoc, Xoc, Xoc, Xoc, Xoc, Xoc, Xoc, Xoc, Xoc, Xoc, Xoc, Xoc
Xoc, Xoc, Xoc, Xoc, Xoc, Xoc, Xoc, Xoc, Xoc, Xoc, Xoi, Xoi, Xoi, Xoi, Isr, Isr^Ebn, Isr, Isc, Isc, Xoi, Xoi, Xoc, Xoc, Xoc, Xoc, Xoc, Xoc, Xoc, Xoc, Xoc, Xoc, Xoc, Xoc, Xoc, Xoc, Xoc, Xoc
Xoc, Xoc, Xoc, Xoc, Xoc, Xoc, Xoc, Xoc, Xoi, Xoc, Xoi, Xoi, Isr^Efs, Isc, Isc, Isr, Isr, Isr, Isr, Isc, Xoi, Xoi, Xoc, Xoc, Xoc, Xoc, Xoc, Xoc, Xoc, Xoc, Xoc, Xoc, Xoc, Xoc, Xoc, Xoc, Xoc
Xoc, Xoc, Xoc, Xoc, Xoc, Xoc, Xoc, Xoc, Xoi, Xoi, Isc, Isr, Isr^Efs, Isr^Efs, Isc, Isc, Isr, Isr, Isr, Isr, Isr^Ebn, Xoi, Xoc, Xoc, Xoc, Xoc, Isr, Xoc, Xoc, Xoc, Xoc, Xoc, Xoc, Xoc, Xoc, Xoc, Xoc
Xoc, Xoc, Xoc, Xoc, Xoc, Xoc, Xoc, Xoc, Xoi, Isr, Isr, Isc, Isc, Isc, Isr, Isr, Isr, Isr, Isr, Isr, Isr, Xoi, Xoc, Xoc, Xoc, Isr, Isr, Xoc, Xoc, Xoc, Xoc, Xoc, Xoc, Xoc, Xoc, Xoc, Xoc
Xoc, Xoc, Xoc, Xoc, Xoc, Xoc, Xoc, Xoc, Xoi, Isr, Isr, Isr, Isr, Isr, Isr, Isr, Isr, Isr, Isr, Isr, Isr, Xoi, Xoc, Xoc, Xoc, Isr^Xo, Xoc, Xoc, Isr^Xo, Xoc, Isr, Xoc, Xoc, Xoc, Xoc, Xoc, Xoc
Xoc, Xoc, Xoc, Xoc, Xoc, Xoc, Xoc, Xoc, Xoi, Isr^Ebn, Isr, Isr, Isr, Isr, Isr, Isr, Isr, Isr, Isr, Isr, Xoi, Xoi, Xoc, Xoc, Xoc, Isr, Isr, Isr, Xoc, Isr, Xoc, Isr, Xoc, Xoc, Xoc^Efs, Xoc, Isr
Xoc, Xoc, Xoc, Xoc, Xoc, Xoc, Xoc, Xoc, Xoc, Xoi, Isc, Isr, Isr, Isr, Isr, Isr, Isr, Isr, Isr, Xoi^Efs, Xoc, Xoc, Xoc, Xoc, Isr^Eqf, Isr, Xoc, Xoc, Xoc, Xoc, Xoc, Xoc, Xoc, Xoc, Isr, Isr, Isr
Xoc, Xoc, Xoc, Xoc, Xoc, Xoc, Xoc, Xoc, Xoc, Xoc, Xoc, Isc, Isc, Isr, Isr^Ebn, Isr, Xoi, Isr, Isr, Isr, Isr, Xoc^Efs, Isr, Isr, Isr, Xoc, Isr, Xoc, Xoc, Xoc, Xoc^Efs, Xoc, Isr, Isr, Isr, Isr, Xoc
Xoc, Xoc, Xoc, Xoc, Xoc, Xoc, Xoc, Xoc, Xoc, Xoc, Xoc, Xoc, Xoc, Xoi, Xoi, Xoi, Xoc, Xoc, Xoc, Isr, Isr, Isr, Isr, Isr, Isr, Isr, Isr, Isr, Isr, Isr, Isr, Isr, Isr, Isr, Xoc, Xoc, Xoc
Xoc, Xoc, Xoc, Xoc, Xoc, Xoc, Xoc, Xoc, Xoc, Xoc, Xoc, Xoc, Xoc, Xoc, Isr, Xoc, Isr^Xo, Xoc, Isr^Eqf, Isr, Isr, Isr, Isr, Isr, Xoc, Isr, Xoc, Isr, Xoc, Isr, Isr, Xoc, Xoc, Xoc, Xoc, Xoc, Xoc
Xoc, Xoc, Xoc, Xoc, Xoc, Xoc, Xoc, Xoc, Xoc, Xoc, Xoc, Xoc, Xoc, Xoc, Xoc, Isr, Xoc, Isr, Xoc, Xoc, Xoc, Xoc, Xoc, Xoc, Xoc, Xoc, Xoc, Xoc, Xoc, Xoc, Isr, Xoc, Xoc, Xoc, Xoc, Xoc, Xoc
Xoc, Xoc, Xoc, Xoc, Xoc, Xoc, Xoc, Xoc, Xoc, Xoc, Xoc, Xoc, Xoc, Xoc, Xoc, Xoc, Xoc, Xoc, Xoc, Xoc, Xoc, Xoc, Xoc, Xoc, Xoc, Xoc, Xoc^Efs, Xoc, Xoc, Xoc, Isr^Qov, Xoc, Xoc, Xoc, Xoc, Xoc, Xoc
Xoc, Xoc, Xoc, Xoc, Xoc, Xoc, Xoc, Xoc, Xoc, Xoc, Xoc, Xoc, Xoc, Xoc, Xoc, Xoc, Xoc, Xoc, Xoc, Xoc, Xoc, Xoc, Xoc, Xoc, Xoc, Xoc, Isr, Isr, Isr, Isr^Eqf, Xoc, Xoc, Xoc, Xoc, Xoc, Xoc, Xoc
Xoc, Xoc, Xoc, Xoc, Xoc, Xoc, Xoc, Xoc, Xoc, Xoc, Xoc, Xoc, Xoc, Xoc, Xoc, Xoc, Xoc, Xoc, Xoc, Xoc, Xoc, Xoc, Xoc, Xoc, Xoc, Isr, Xoc, Isr, Xoc, Xoc, Xoc, Xoc, Xoc, Xoc, Xoc, Xoc, Xoc
Xoc, Xoc, Xoc, Xoc, Xoc, Xoc, Xoc, Xoc, Xoc, Xoc, Xoc, Xoc, Xoc, Xoc, Xoc, Xoc, Xoc, Xoc, Xoc, Xoc, Xoc, Xoc, Xoc, Xoc, Xoc, Xoc, Xoc, Xoc, Xoc, Xoc, Xoc, Xoc, Xoc, Xoc, Xoc, Xoc, Xoc
Xoc, Xoc, Xoc, Xoc, Xoc, Xoc, Xoc, Xoc, Xoc, Xoc, Xoc, Xoc, Xoc, Xoc, Xoc, Xoc, Xoc, Xoc, Xoc, Xoc, Xoc, Xoc, Xoc, Xoc, Xoc, Xoc, Xoc, Xoc, Xoc, Xoc, Xoc, Xoc, Xoc, Xoc, Xoc, Xoc, Xoc
Xoc, Xoc, Xoc, Xoc, Xoc, Xoc, Xoc, Xoc, Xoc, Xoc, Xoc, Xoc, Xoc, Xoc, Xoc, Xoc, Xoc, Xoc, Xoc, Xoc, Xoc, Xoc, Xoc, Xoc, Xoc, Xoc, Xoc, Xoc, Xoc, Xoc, Xoc, Xoc, Xoc, Xoc, Xoc, Xoc, Xoc
_off^_usr, Xoc, _off^_usr, Xoc, _off^_usr, Xoc, _off^_usr, Xoc, _off^_usr, Xoc, _off^_usr, Xoc, _off^_usr, Xoc, _off^_usr, Xoc, _off^_usr, Xoc, _off^_usr, Xoc, _off^_usr, Xoc, _off^_usr, Xoc, _off^_usr, Xoc, _off^_usr, Xoc, _off^_usr, Xoc, _off^_usr, Xoc, _off^_usr, Xoc, _off^_usr, Xoc, _off^_usr
_off^_usr, _off^_usr, _off^_usr, _off^_usr, _off^_usr, _off^_usr, _off^_usr, _off^_usr, _off^_usr, _off^_usr, _off^_usr, _off^_usr, _off^_usr, _off^_usr, _off^_usr, _off^_usr, _off^_usr, _off^_usr, _off^_usr, _off^_usr, _off^_usr, _off^_usr, _off^_usr, _off^_usr, _off^_usr, _off^_usr, _off^_usr, _off^_usr, _off^_usr, _off^_usr, _off^_usr, _off^_usr, _off^_usr, _off^_usr, _off^_usr, _off^_usr, _off^_usr
_off^_usr, _off^_usr, _off^_usr, _off^_usr, _off^_usr, _off^_usr, _off^_usr, _off^_usr, _off^_usr, _off^_usr, _off^_usr, _off^_usr, _off^_usr, _off^_usr, _off^_usr, _off^_usr, _off^_usr, _off^_usr, _off^_usr, _off^_usr, _off^_usr, _off^_usr, _off^_usr, _off^_usr, _off^_usr, _off^_usr, _off^_usr, _off^_usr, _off^_usr, _off^_usr, _off^_usr, _off^_usr, _off^_usr, _off^_usr, _off^_usr, _off^_usr, _off^_usr
_off^_usr, _off^_usr, _off^_usr, _off^_usr, _off^_usr, _off^_usr, _off^_usr, _off^_usr, _off^_usr, _off^_usr, _off^_usr, _off^_usr, _off^_usr, _off^_usr, _off^_usr, _off^_usr, _off^_usr, _off^_usr, _off^_usr, _off^_usr, _off^_usr, _off^_usr, _off^_usr, _off^_usr, _off^_usr, _off^_usr, _off^_usr, _off^_usr, _off^_usr, _off^_usr, _off^_usr, _off^_usr, _off^_usr, _off^_usr, _off^_usr, _off^_usr, _off^_usr
Gs^Fms, _off^_usr, Gs^Fms, _off^_usr, Gs^Fms, _off^_usr, Gs^Fms, _off^_usr, Gs^Fms, _off^_usr, Gg, _off^_usr, Gg, _off^_usr, Hh, _off^_usr, Gg, _off^_usr, Re, _off^_usr, Gs^Fds, _off^_usr, Gs^Fds, _off^_usr, Gg, _off^_usr, Ww, _off^_usr, Gs^Fds, _off^_usr, Gg, _off^_usr, Ww, _off^_usr, Ww, _off^_usr, Gg
Gs^Fms, Gs^Fms, Gs^Fds, Gs^Fms, Gs^Fms, Gs^Fms, Gg, Gs^Fms, Gg, Gg, Gg, Gg, Hh, Hh, Hh, Gg, Gg, Gg, Re, Gg, Gs^Fds, Gs^Fds, Re, Gs^Fds, Gs^Vh, Ww, Ww, Ww, Ww, Gg, Ww, Ww, Gg, Gg, Gg, Gg, Gs^Fds
Gs^Fds, Gs^Fds, Ww, Gs^Fds, Gs^Fms, Gs^Fms, Gg, Gg, Gg, Ww, Ww, Gg, Gg, Hh, Gs^Fds, Gs^Fds, Gs^Fds, Gg, Gg, Re, Re, Re, Gs^Fds, Re, Re, Gg, Gg, Gg, Ww, Ww, Gs^Fds, Gg, Gg, Gg, Gs^Fds, Gs^Fds, Gs^Fds
Gs^Fds, Gs^Fds, Ww, Ww, Ww, Gg, Gs^Vh, Gg, Gg, Ww, Ww, Gg, Gs^Fds, Gs^Fds, Gs^Fds, Gs^Fds, Gs^Fds, Gs^Fds, Gg, Re, Gll, Gs^Fds, Gs^Fds, Gs^Fds, Gll, Re, Re, Gg, Ww, Ww, Gs^Vh, Re, Gg, Gs^Fds, Gs^Fds, Gs^Fds, Gs^Fds
Gs^Fds, Gs^Fds, Gs^Fds, Gs^Fds, Ww, Gg, Gg, Gg, Gg, Gg, Gg, Gg, Gs^Fds, Gs^Fds, Gs^Fds, Gs^Fds, Gs^Fds, Gs^Fds, Gg, Re, Gs^Vh, Gs^Fds, Gs^Fds, Gs^Fds, Gs^Fds, Gs^Fds, Re, Gg, Gg, Ww, Ww^Bw/, Re, Gg, Gs^Fds, Gg, Gg, Gs^Fds
Gs^Fds, Gs^Fds, Gs^Fds, Gs^Fds, Ww, Gg, Hh, Hh, Hh, Gg, Gg, Gs^Fds, Gs^Fds, Gs^Fds, Gs^Fds, Gs^Fds, Gs^Fds, Gs^Fds, Gg, Re, Gg, Gs^Fds, Gs^Fds, Gs^Fds, Gs^Fds, Gs^Fds, Gs^Fds, Re, Re, Re, Ww, Ww, Ww, Gg, Ww, Gg, Gg
Gs^Fds, Gs^Fds, Gs^Fds, Ww, Ww, Hh, Hh, Hh, Hh, Gg, Hh, Gg, Gg, Gg, Gg, Gs^Fds, Gs^Fds, Gs^Fds, Gg, Re, Gg, Gg, Gs^Fds, Gs^Fds, Gs^Fds, Gs^Fds, Gg, Gg, Gg, Gs^Vh, Ww, Ww, Ww, Ww, Ww, Ww, Ww
Gs^Fds, Gs^Fds, Gs^Fds, Gs^Fds, Ww, Hh, Hh, Hh, Hh, Hh, Hh, Hh, Hh, Gs^Vh, Hh, Hh, Hh, Gg, Re, Re, Gs^Fds, Gs^Fds, Gs^Fds, Gs^Fds, Gs^Fds, Gg, Ww, Gg, Gg, Gg, Ww, Ww, Ww, Ww, Ww, Ww, Ww
Gs^Fds, Gs^Fds, Gs^Fds, Gs^Fds, Ww, Gg, Ww, Ww, Ww^Bw|r, Hh, Ww, Hh, Hh, Hh, Hh, Hh, Hh, Gg, Re, Gg, Gs^Fds, Gs^Fds, Gs^Fds, Gs^Fds, Gg, Ww, Ww, Ww, Ww, Ww, Ww, Ww, Wo, Wo, Wo, Wo, Wo
Gs^Fds, Gs^Fds, Gs^Fds, Ww, Wo, Ww, Ww, Ww, Gs^Vh, Ww, Hh, Ww, Hh, Hh, Gg, Hh, Gg, Gg, Re, Gg, Gg, Gs^Fds, Gs^Fds, Gs^Fds, Gg, Ww, Ww, Ww, Ww, Ww, Wo, Ww, Wo, Wo, Wo, Wo, Wo
Gs^Fds, Gs^Fds, Gs^Fds, Ww, Ww, Wo, Ww, Gg, Hh, Hh, Mm, Hh, Hh, Hh, Re, Gg, Re, Re, Hh, Gs^Vh, Gg, Gg, Ww, Gg, Ww, Ww, Ww, Ww, Wo, Ww, Wo, Wo, Wo, Wo, Wo, Wo, Wo
Gs^Fds, Gs^Fds, Gs^Fds, Gs^Fds, Ww, Ww, Hh, Hh, Mm, Mm, Mm, Mm, Mm, Mm, Re, Re, Hh, Hh, Hh, Hh, Gg, Ww, Gg, Ww, Gg, Ww, Ww, Wo, Wo, Wo, Wo, Wo, Wo, Wo, Wo, Wo, Wo
Gs^Fds, Gs^Fds, Gg, Gs^Fds, Ww, Hh, Hh, Hh, Hh, Hh, Mm, Mm, Hh, Re, Mm, Hh, Hh, Hh, Gg, Gg, Gs^Fds, Gs^Fds, Gs^Fds, Gg, Gg, Ww, Ww, Wo, Wo, Wo, Wo, Wo, Wo, Wo, Wo, Wo, Wo
Gg, Gg, Gg, Gg, Ww, Hh, Hh, Hh, Hh, Mm, Mm, Mm, Mm, Re, Mm, Hh, Hh, Hh, Hh, Gg, Gs^Fds, Gg, Gs^Fds, Gs^Vh, Ww, Ww, Ww, Ww, Wo, Wo, Wo, Wo, Wo, Wo, Wo, Wo, Wo
Gg, Gg, Gs^Vh, Gg, Ww, Hh, Hh, Hh, Mm, Mm, Mm, Mm, Cud, Re, Mm, Hh, Hh, Hh, Hh, Gs^Fds, Gs^Fds, Gs^Fds, Gs^Fds, Gg, Ww, Ww, Ww, Ww, Wo, Wo, Wo, Wo, Wo, Wo, Wo, Wo, Wo
Ww, Ww, Ww, Ww, Gg, Gg, Hh, Hh, Mm, Mm, Mm, Cud, Kud, Cud, Mm, Mm, Hh, Hh, Gs^Vh, Hh, Gg, Gs^Fds, Ww, Ww, Ww, Ww, Ww, Wo, Wo, Wo, Wo, Wo, Wo, Wo, Wo, Wo, Wo
Ww, Ww, Ww, Ww, Gg, Gg, Gg, Hh, Hh, Mm, Mm, Cud, Cud, Cud, Mm, Mm, Hh, Hh, Hh, Hh, Gg, Gg, Ww, Ww, Wo, Ww, Wo, Wo, Wo, Wo, Wo, Wo, Wo, Wo, Wo, Wo, Wo
Ww, Ww, Ww, Ww, Ww, Gg, Gg, Hh, Hh, Hh, Hh, Mm, Mm, Mm, Mm, Mm, Hh, Hh, Hh, Gg, Gg, Gg, Ww, Ww, Ww, Wo, Wo, Wo, Wo, Wo, Wo, Wo, Wo, Wo, Wo, Wo, Wo
Wo, Wo, Ww, Ww, Ww, Gg, Gg, Gg, Hh, Hh, Hh, Hh, Hh, Hh, Gs^Vh, Hh, Gg, Hh, Gg, Gg, Ww, Ww, Ww, Ww, Ww, Wo, Wo, Wo, Wo, Wo, Wo, Wo, Wo, Wo, Wo, Wo, Wo
Wo, Wo, Ww, Ww, Ww, Ww, Gg, Gg, Gg, Hh, Hh, Hh, Gg, Gs^Fds, Gs^Fds, Gs^Fds, Gs^Fds, Gg, Gg, Gg, Ww, Ww, Ww, Ww, Wo, Wo, Wo, Wo, Wo, Wo, Wo, Wo, Wo, Wo, Wo, Wo, Wo
Wo, Wo, Wo, Wo, Ww, Ww, Ww, Gg, Ww, Gg, Gs^Vh, Gg, Gg, Gs^Fds, Gs^Fds, Gs^Fds, Gs^Fds, Gs^Fds, Gg, Ww, Ww, Ww, Ww, Wo, Wo, Wo, Wo, Wo, Wo, Wo, Wo, Wo, Wo, Wo, Wo, Wo, Wo
Wo, Wo, Wo, Wo, Wo, Ww, Ww, Ww, Ww, Gg, Gg, Gg, Ww, Gg, Ww, Gg, Ww, Gg, Ww, Ww, Ww, Ww, Wo, Wo, Wo, Wo, Wo, Wo, Wo, Wo, Wo, Wo, Wo, Wo, Wo, Wo, Wo
Wo, Wo, Wo, Wo, Wo, Wo, Ww, Ww, Ww, Ww, Ww, Ww, Ww, Ww, Ww, Ww, Ww, Ww, Ww, Ww, Ww, Ww, Wo, Wo, Wo, Wo, Wo, Wo, Wo, Wo, Wo, Wo, Wo, Wo, Wo, Wo, Wo
Wo, Wo, Wo, Wo, Wo, Ww, Ww, Ww, Ww, Ww, Ww, Ww, Ww, Ww, Wo, Ww, Ww, Ww, Ww, Ww, Ww, Ww, Wo, Wo, Wo, Wo, Wo, Wo, Wo, Wo, Wo, Wo, Wo, Wo, Wo, Wo, Wo
